,filename,model,error,predicted,groundTruth,,error avg,,
0,p172_color_image0.jpg,124,-5,68,73,0.344370861,-0.221192053,71.99735099,72.21854305
1,p175_color_image0.jpg,124,1,78,77,,error stdev,,
2,P188_color_image0.jpg,124,3,79,76,,5.893002113,,
3,p191_color_image0.jpg,124,5,75,70,,,,
4,p196_color_image0.jpg,124,-11,60,71,,,,
5,p197_color_image0.jpg,124,4,81,77,,,,
6,p198_color_image0.jpg,124,-6,66,72,,,,
7,p200_color_image0.jpg,124,2,79,77,,,,
8,P210_color_image0.jpg,124,0,78,78,,,,
9,p211_color_image0.jpg,124,5,80,75,,,,
10,P220_color_image0.jpg,124,10,80,70,,,,
11,p222_color_image0.jpg,124,2,71,69,,,,
12,p223_color_image0.jpg,124,-1,64,65,,,,
13,p230_color_image0.jpg,124,16,74,58,,,,
14,p232-2_color_image0.jpg,124,2,77,75,,,,
15,p237-1_color_image0.jpg,124,6,79,73,,,,
16,p240_color_image0.jpg,124,-8,71,79,,,,
17,p249_color_image0.jpg,124,-5,71,76,,,,
18,p250_color_image0.jpg,124,0,68,68,,,,
19,p253_color_image0.jpg,124,-4,72,76,,,,
20,p255_color_image0.jpg,124,-1,73,74,,,,
21,p256_color_image0.jpg,124,-2,69,71,,,,
22,p260_color_image0.jpg,124,-4,72,76,,,,
23,p261_color_image0.jpg,124,0,72,72,,,,
24,p263_color_image0.jpg,124,4,72,68,,,,
25,P267_color_image0.jpg,124,4,72,68,,,,
26,p272_color_image0.jpg,124,0,72,72,,,,
27,p279_color_image0.jpg,124,9,72,63,,,,
28,P280_color_image0.jpg,124,-1,71,72,,,,
29,P282_color_image0.jpg,124,8,80,72,,,,
30,p284_color_image0.jpg,124,-3,72,75,,,,
31,p287_color_image0.jpg,124,3,74,71,,,,
32,p288_color_image0.jpg,124,-8,70,78,,,,
33,p289_color_image0.jpg,124,1,72,71,,,,
34,p302_color_image0.jpg,124,6,78,72,,,,
35,p306_color_image0.jpg,124,5,75,70,,,,
36,p311_color_image0.jpg,124,2,80,78,,,,
37,P321_color_image0.jpg,124,2,79,77,,,,
38,p327_color_image0.jpg,124,-6,71,77,,,,
39,p344_color_image0.jpg,124,2,72,70,,,,
40,p345_color_image0.jpg,124,2,69,67,,,,
41,p346-1_color_image0.jpg,124,-3,65,68,,,,
42,p347_color_image0.jpg,124,-7,66,73,,,,
43,p351_color_image0.jpg,124,1,71,70,,,,
44,P354_color_image0.jpg,124,-6,71,77,,,,
45,p362_color_image0.jpg,124,-6,69,75,,,,
46,p366_color_image0.jpg,124,0,78,78,,,,
47,p368_color_image0.jpg,124,4,72,68,,,,
48,p378_color_image0.jpg,124,-1,77,78,,,,
49,p386_color_image0.jpg,124,-6,71,77,,,,
50,P395_color_image0.jpg,124,-5,72,77,,,,
51,p397_color_image0.jpg,124,1,73,72,,,,
52,p398_color_image0.jpg,124,-6,70,76,,,,
53,p399_color_image0.jpg,124,0,71,71,,,,
54,p403_color_image0.jpg,124,-1,74,75,,,,
55,p412_color_image0.jpg,124,7,79,72,,,,
56,p415_color_image0.jpg,124,5,75,70,,,,
57,p422_color_image0.jpg,124,12,68,56,,,,
58,p424_color_image0.jpg,124,10,79,69,,,,
59,p425_color_image0.jpg,124,-3,72,75,,,,
60,p430_color_image0.jpg,124,-3,74,77,,,,
61,p431_color_image0.jpg,124,0,72,72,,,,
62,p432_color_image0.jpg,124,-4,72,76,,,,
63,p435_color_image0.jpg,124,-1,72,73,,,,
64,p438_color_image0.jpg,124,-6,72,78,,,,
65,P439_color_image0.jpg,124,10,80,70,,,,
66,p440_color_image0.jpg,124,-6,71,77,,,,
67,p441_color_image0.jpg,124,3,73,70,,,,
68,p442_color_image0.jpg,124,1,72,71,,,,
69,p445_color_image0.jpg,124,-3,72,75,,,,
70,p452_color_image0.jpg,124,-7,71,78,,,,
71,p454_color_image0.jpg,124,1,69,68,,,,
72,p462_color_image0.jpg,124,-8,69,77,,,,
73,P467_color_image0.jpg,124,-1,74,75,,,,
74,p469_color_image0.jpg,124,-5,72,77,,,,
75,P472_color_image0.jpg,124,3,79,76,,,,
76,p474_color_image0.jpg,124,2,72,70,,,,
77,p477_color_image0.jpg,124,4,80,76,,,,
78,P481_color_image0.jpg,124,2,77,75,,,,
79,P482_color_image0.jpg,124,-3,69,72,,,,
80,P484_color_image0.jpg,124,6,71,65,,,,
81,P485_color_image0.jpg,124,15,79,64,,,,
82,P491_color_image0.jpg,124,-14,63,77,,,,
83,P495_color_image0.jpg,124,5,74,69,,,,
84,P499_color_image0.jpg,124,9,72,63,,,,
85,P501_color_image0.jpg,124,-7,64,71,,,,
86,P505_color_image0.jpg,124,4,72,68,,,,
87,P507_color_image0.jpg,124,-4,72,76,,,,
88,P509_color_image0.jpg,124,-1,77,78,,,,
89,P510_color_image0.jpg,124,-4,73,77,,,,
90,P515_color_image0.jpg,124,-8,65,73,,,,
91,P518_color_image0.jpg,124,-6,72,78,,,,
92,P519_color_image0.jpg,124,9,79,70,,,,
93,P521_color_image0.jpg,124,10,74,64,,,,
94,P525_color_image0.jpg,124,2,78,76,,,,
95,P529_color_image0.jpg,124,3,71,68,,,,
96,P551_color_image0.jpg,124,3,78,75,,,,
97,P556_color_image0.jpg,124,-2,69,71,,,,
98,P557_color_image0.jpg,124,8,79,71,,,,
99,P564_color_image0.jpg,124,2,69,67,,,,
100,P565_color_image0.jpg,124,8,71,63,,,,
101,P572_color_image0.jpg,124,2,80,78,,,,
102,P575_color_image0.jpg,124,14,72,58,,,,
103,P576_color_image0.jpg,124,2,69,67,,,,
104,P577_color_image0.jpg,124,-5,72,77,,,,
105,P578_color_image0.jpg,124,4,73,69,,,,
106,P582_color_image0.jpg,124,3,72,69,,,,
107,P585_color_image0.jpg,124,-2,69,71,,,,
108,P586_color_image0.jpg,124,-12,66,78,,,,
109,P592_color_image0.jpg,124,-5,64,69,,,,
110,P594_color_image0.jpg,124,-6,72,78,,,,
111,P596_color_image0.jpg,124,9,81,72,,,,
112,P601_color_image0.jpg,124,-10,62,72,,,,
113,P602_color_image0.jpg,124,1,70,69,,,,
114,P605_color_image0.jpg,124,1,72,71,,,,
115,P606_color_image0.jpg,124,0,77,77,,,,
116,P609_color_image0.jpg,124,1,72,71,,,,
117,P612_color_image0.jpg,124,-3,72,75,,,,
118,P617_color_image0.jpg,124,3,77,74,,,,
119,P618-1_color_image0.jpg,124,1,75,74,,,,
120,P619_color_image0.jpg,124,2,79,77,,,,
121,P622_color_image0.jpg,124,0,75,75,,,,
122,P632_color_image0.jpg,124,-7,72,79,,,,
123,P635_color_image0.jpg,124,-7,70,77,,,,
124,P636_color_image0.jpg,124,5,78,73,,,,
125,P638_color_image0.jpg,124,2,75,73,,,,
126,P645_color_image0.jpg,124,-12,64,76,,,,
127,P651_color_image0.jpg,124,-3,69,72,,,,
128,P653_color_image0.jpg,124,-4,73,77,,,,
129,P673_color_image0.jpg,124,-8,69,77,,,,
130,P674_color_image0.jpg,124,7,80,73,,,,
131,P676_color_image0.jpg,124,12,76,64,,,,
132,P677_color_image0.jpg,124,-8,70,78,,,,
133,P680_color_image0.jpg,124,0,69,69,,,,
134,P681_color_image0.jpg,124,7,79,72,,,,
135,P690_color_image0.jpg,124,7,70,63,,,,
136,P694_color_image0.jpg,124,-10,67,77,,,,
137,P703_color_image0.jpg,124,-1,65,66,,,,
138,P704_color_image0.jpg,124,8,80,72,,,,
139,P710_color_image0.jpg,124,-1,69,70,,,,
140,P712_color_image0.jpg,124,-6,62,68,,,,
141,P717_color_image0.jpg,124,1,72,71,,,,
142,P724_color_image0.jpg,124,8,75,67,,,,
143,P728_color_image0.jpg,124,-4,73,77,,,,
144,P742-1_color_image0.jpg,124,3,72,69,,,,
145,P744_color_image0.jpg,124,-7,66,73,,,,
146,P745-1_color_image0.jpg,124,-2,69,71,,,,
147,P747_color_image0.jpg,124,-1,64,65,,,,
148,P759-1_color_image0.jpg,124,3,81,78,,,,
149,P766-1_color_image0.jpg,124,14,70,56,,,,
150,P776-1_color_image0.jpg,124,4,72,68,,,,
151,p172_color_image0.jpg,94,-7,66,73,-0.668874172,,,
152,p175_color_image0.jpg,94,-1,76,77,,,,
153,P188_color_image0.jpg,94,-4,72,76,,,,
154,p191_color_image0.jpg,94,1,71,70,,,,
155,p196_color_image0.jpg,94,-10,61,71,,,,
156,p197_color_image0.jpg,94,-6,71,77,,,,
157,p198_color_image0.jpg,94,-4,68,72,,,,
158,p200_color_image0.jpg,94,-6,71,77,,,,
159,P210_color_image0.jpg,94,-5,73,78,,,,
160,p211_color_image0.jpg,94,-3,72,75,,,,
161,P220_color_image0.jpg,94,5,75,70,,,,
162,p222_color_image0.jpg,94,2,71,69,,,,
163,p223_color_image0.jpg,94,-2,63,65,,,,
164,p230_color_image0.jpg,94,11,69,58,,,,
165,p232-2_color_image0.jpg,94,0,75,75,,,,
166,p237-1_color_image0.jpg,94,-2,71,73,,,,
167,p240_color_image0.jpg,94,-12,67,79,,,,
168,p249_color_image0.jpg,94,-2,74,76,,,,
169,p250_color_image0.jpg,94,0,68,68,,,,
170,p253_color_image0.jpg,94,-4,72,76,,,,
171,p255_color_image0.jpg,94,-2,72,74,,,,
172,p256_color_image0.jpg,94,1,72,71,,,,
173,p260_color_image0.jpg,94,-4,72,76,,,,
174,p261_color_image0.jpg,94,-2,70,72,,,,
175,p263_color_image0.jpg,94,3,71,68,,,,
176,P267_color_image0.jpg,94,4,72,68,,,,
177,p272_color_image0.jpg,94,-6,66,72,,,,
178,p279_color_image0.jpg,94,9,72,63,,,,
179,P280_color_image0.jpg,94,-3,69,72,,,,
180,P282_color_image0.jpg,94,5,77,72,,,,
181,p284_color_image0.jpg,94,-4,71,75,,,,
182,p287_color_image0.jpg,94,1,72,71,,,,
183,p288_color_image0.jpg,94,-6,72,78,,,,
184,p289_color_image0.jpg,94,3,74,71,,,,
185,p302_color_image0.jpg,94,4,76,72,,,,
186,p306_color_image0.jpg,94,2,72,70,,,,
187,p311_color_image0.jpg,94,-3,75,78,,,,
188,P321_color_image0.jpg,94,-5,72,77,,,,
189,p327_color_image0.jpg,94,-5,72,77,,,,
190,p344_color_image0.jpg,94,0,70,70,,,,
191,p345_color_image0.jpg,94,4,71,67,,,,
192,p346-1_color_image0.jpg,94,-3,65,68,,,,
193,p347_color_image0.jpg,94,-5,68,73,,,,
194,p351_color_image0.jpg,94,1,71,70,,,,
195,P354_color_image0.jpg,94,-11,66,77,,,,
196,p362_color_image0.jpg,94,-4,71,75,,,,
197,p366_color_image0.jpg,94,0,78,78,,,,
198,p368_color_image0.jpg,94,4,72,68,,,,
199,p378_color_image0.jpg,94,-7,71,78,,,,
200,p386_color_image0.jpg,94,-8,69,77,,,,
201,P395_color_image0.jpg,94,-9,68,77,,,,
202,p397_color_image0.jpg,94,0,72,72,,,,
203,p398_color_image0.jpg,94,-5,71,76,,,,
204,p399_color_image0.jpg,94,1,72,71,,,,
205,p403_color_image0.jpg,94,2,77,75,,,,
206,p412_color_image0.jpg,94,0,72,72,,,,
207,p415_color_image0.jpg,94,2,72,70,,,,
208,p422_color_image0.jpg,94,15,71,56,,,,
209,p424_color_image0.jpg,94,8,77,69,,,,
210,p425_color_image0.jpg,94,-3,72,75,,,,
211,p430_color_image0.jpg,94,-3,74,77,,,,
212,p431_color_image0.jpg,94,-1,71,72,,,,
213,p432_color_image0.jpg,94,-1,75,76,,,,
214,p435_color_image0.jpg,94,-2,71,73,,,,
215,p438_color_image0.jpg,94,-9,69,78,,,,
216,P439_color_image0.jpg,94,3,73,70,,,,
217,p440_color_image0.jpg,94,-7,70,77,,,,
218,p441_color_image0.jpg,94,2,72,70,,,,
219,p442_color_image0.jpg,94,5,76,71,,,,
220,p445_color_image0.jpg,94,-3,72,75,,,,
221,p452_color_image0.jpg,94,2,80,78,,,,
222,p454_color_image0.jpg,94,-3,65,68,,,,
223,p462_color_image0.jpg,94,-6,71,77,,,,
224,P467_color_image0.jpg,94,-1,74,75,,,,
225,p469_color_image0.jpg,94,0,77,77,,,,
226,P472_color_image0.jpg,94,-2,74,76,,,,
227,p474_color_image0.jpg,94,-2,68,70,,,,
228,p477_color_image0.jpg,94,0,76,76,,,,
229,P481_color_image0.jpg,94,3,78,75,,,,
230,P482_color_image0.jpg,94,-9,63,72,,,,
231,P484_color_image0.jpg,94,9,74,65,,,,
232,P485_color_image0.jpg,94,15,79,64,,,,
233,P491_color_image0.jpg,94,-5,72,77,,,,
234,P495_color_image0.jpg,94,8,77,69,,,,
235,P499_color_image0.jpg,94,9,72,63,,,,
236,P501_color_image0.jpg,94,-6,65,71,,,,
237,P505_color_image0.jpg,94,4,72,68,,,,
238,P507_color_image0.jpg,94,-5,71,76,,,,
239,P509_color_image0.jpg,94,-10,68,78,,,,
240,P510_color_image0.jpg,94,-6,71,77,,,,
241,P515_color_image0.jpg,94,3,76,73,,,,
242,P518_color_image0.jpg,94,-8,70,78,,,,
243,P519_color_image0.jpg,94,0,70,70,,,,
244,P521_color_image0.jpg,94,6,70,64,,,,
245,P525_color_image0.jpg,94,-6,70,76,,,,
246,P529_color_image0.jpg,94,-6,62,68,,,,
247,P551_color_image0.jpg,94,1,76,75,,,,
248,P556_color_image0.jpg,94,-6,65,71,,,,
249,P557_color_image0.jpg,94,9,80,71,,,,
250,P564_color_image0.jpg,94,2,69,67,,,,
251,P565_color_image0.jpg,94,7,70,63,,,,
252,P572_color_image0.jpg,94,-5,73,78,,,,
253,P575_color_image0.jpg,94,14,72,58,,,,
254,P576_color_image0.jpg,94,5,72,67,,,,
255,P577_color_image0.jpg,94,-6,71,77,,,,
256,P578_color_image0.jpg,94,0,69,69,,,,
257,P582_color_image0.jpg,94,9,78,69,,,,
258,P585_color_image0.jpg,94,4,75,71,,,,
259,P586_color_image0.jpg,94,-7,71,78,,,,
260,P592_color_image0.jpg,94,-2,67,69,,,,
261,P594_color_image0.jpg,94,-4,74,78,,,,
262,P596_color_image0.jpg,94,6,78,72,,,,
263,P601_color_image0.jpg,94,-4,68,72,,,,
264,P602_color_image0.jpg,94,4,73,69,,,,
265,P605_color_image0.jpg,94,1,72,71,,,,
266,P606_color_image0.jpg,94,-6,71,77,,,,
267,P609_color_image0.jpg,94,5,76,71,,,,
268,P612_color_image0.jpg,94,-1,74,75,,,,
269,P617_color_image0.jpg,94,0,74,74,,,,
270,P618-1_color_image0.jpg,94,5,79,74,,,,
271,P619_color_image0.jpg,94,-10,67,77,,,,
272,P622_color_image0.jpg,94,-3,72,75,,,,
273,P632_color_image0.jpg,94,-7,72,79,,,,
274,P635_color_image0.jpg,94,-11,66,77,,,,
275,P636_color_image0.jpg,94,-1,72,73,,,,
276,P638_color_image0.jpg,94,4,77,73,,,,
277,P645_color_image0.jpg,94,-3,73,76,,,,
278,P651_color_image0.jpg,94,-1,71,72,,,,
279,P653_color_image0.jpg,94,-6,71,77,,,,
280,P673_color_image0.jpg,94,-6,71,77,,,,
281,P674_color_image0.jpg,94,2,75,73,,,,
282,P676_color_image0.jpg,94,10,74,64,,,,
283,P677_color_image0.jpg,94,-6,72,78,,,,
284,P680_color_image0.jpg,94,2,71,69,,,,
285,P681_color_image0.jpg,94,5,77,72,,,,
286,P690_color_image0.jpg,94,2,65,63,,,,
287,P694_color_image0.jpg,94,-11,66,77,,,,
288,P703_color_image0.jpg,94,5,71,66,,,,
289,P704_color_image0.jpg,94,-1,71,72,,,,
290,P710_color_image0.jpg,94,-9,61,70,,,,
291,P712_color_image0.jpg,94,1,69,68,,,,
292,P717_color_image0.jpg,94,1,72,71,,,,
293,P724_color_image0.jpg,94,4,71,67,,,,
294,P728_color_image0.jpg,94,-4,73,77,,,,
295,P742-1_color_image0.jpg,94,2,71,69,,,,
296,P744_color_image0.jpg,94,3,76,73,,,,
297,P745-1_color_image0.jpg,94,-6,65,71,,,,
298,P747_color_image0.jpg,94,9,74,65,,,,
299,P759-1_color_image0.jpg,94,-7,71,78,,,,
300,P766-1_color_image0.jpg,94,13,69,56,,,,
301,P776-1_color_image0.jpg,94,4,72,68,,,,
302,p172_color_image0.jpg,125,-8,65,73,-0.430463576,,,
303,p175_color_image0.jpg,125,0,77,77,,,,
304,P188_color_image0.jpg,125,2,78,76,,,,
305,p191_color_image0.jpg,125,-2,68,70,,,,
306,p196_color_image0.jpg,125,-12,59,71,,,,
307,p197_color_image0.jpg,125,-8,69,77,,,,
308,p198_color_image0.jpg,125,-2,70,72,,,,
309,p200_color_image0.jpg,125,-1,76,77,,,,
310,P210_color_image0.jpg,125,-1,77,78,,,,
311,p211_color_image0.jpg,125,2,77,75,,,,
312,P220_color_image0.jpg,125,9,79,70,,,,
313,p222_color_image0.jpg,125,2,71,69,,,,
314,p223_color_image0.jpg,125,8,73,65,,,,
315,p230_color_image0.jpg,125,13,71,58,,,,
316,p232-2_color_image0.jpg,125,2,77,75,,,,
317,p237-1_color_image0.jpg,125,-4,69,73,,,,
318,p240_color_image0.jpg,125,-12,67,79,,,,
319,p249_color_image0.jpg,125,-2,74,76,,,,
320,p250_color_image0.jpg,125,0,68,68,,,,
321,p253_color_image0.jpg,125,-4,72,76,,,,
322,p255_color_image0.jpg,125,-1,73,74,,,,
323,p256_color_image0.jpg,125,0,71,71,,,,
324,p260_color_image0.jpg,125,-6,70,76,,,,
325,p261_color_image0.jpg,125,-1,71,72,,,,
326,p263_color_image0.jpg,125,1,69,68,,,,
327,P267_color_image0.jpg,125,1,69,68,,,,
328,p272_color_image0.jpg,125,-2,70,72,,,,
329,p279_color_image0.jpg,125,9,72,63,,,,
330,P280_color_image0.jpg,125,-1,71,72,,,,
331,P282_color_image0.jpg,125,0,72,72,,,,
332,p284_color_image0.jpg,125,-4,71,75,,,,
333,p287_color_image0.jpg,125,1,72,71,,,,
334,p288_color_image0.jpg,125,-8,70,78,,,,
335,p289_color_image0.jpg,125,3,74,71,,,,
336,p302_color_image0.jpg,125,6,78,72,,,,
337,p306_color_image0.jpg,125,4,74,70,,,,
338,p311_color_image0.jpg,125,-4,74,78,,,,
339,P321_color_image0.jpg,125,-3,74,77,,,,
340,p327_color_image0.jpg,125,-5,72,77,,,,
341,p344_color_image0.jpg,125,-2,68,70,,,,
342,p345_color_image0.jpg,125,3,70,67,,,,
343,p346-1_color_image0.jpg,125,-8,60,68,,,,
344,p347_color_image0.jpg,125,-2,71,73,,,,
345,p351_color_image0.jpg,125,2,72,70,,,,
346,P354_color_image0.jpg,125,-8,69,77,,,,
347,p362_color_image0.jpg,125,-6,69,75,,,,
348,p366_color_image0.jpg,125,-6,72,78,,,,
349,p368_color_image0.jpg,125,3,71,68,,,,
350,p378_color_image0.jpg,125,-6,72,78,,,,
351,p386_color_image0.jpg,125,-5,72,77,,,,
352,P395_color_image0.jpg,125,-8,69,77,,,,
353,p397_color_image0.jpg,125,-1,71,72,,,,
354,p398_color_image0.jpg,125,-7,69,76,,,,
355,p399_color_image0.jpg,125,1,72,71,,,,
356,p403_color_image0.jpg,125,-6,69,75,,,,
357,p412_color_image0.jpg,125,-6,66,72,,,,
358,p415_color_image0.jpg,125,1,71,70,,,,
359,p422_color_image0.jpg,125,10,66,56,,,,
360,p424_color_image0.jpg,125,6,75,69,,,,
361,p425_color_image0.jpg,125,-3,72,75,,,,
362,p430_color_image0.jpg,125,-3,74,77,,,,
363,p431_color_image0.jpg,125,-1,71,72,,,,
364,p432_color_image0.jpg,125,-4,72,76,,,,
365,p435_color_image0.jpg,125,8,81,73,,,,
366,p438_color_image0.jpg,125,-6,72,78,,,,
367,P439_color_image0.jpg,125,3,73,70,,,,
368,p440_color_image0.jpg,125,-8,69,77,,,,
369,p441_color_image0.jpg,125,2,72,70,,,,
370,p442_color_image0.jpg,125,1,72,71,,,,
371,p445_color_image0.jpg,125,-8,67,75,,,,
372,p452_color_image0.jpg,125,-6,72,78,,,,
373,p454_color_image0.jpg,125,-6,62,68,,,,
374,p462_color_image0.jpg,125,-4,73,77,,,,
375,P467_color_image0.jpg,125,-3,72,75,,,,
376,p469_color_image0.jpg,125,-3,74,77,,,,
377,P472_color_image0.jpg,125,-2,74,76,,,,
378,p474_color_image0.jpg,125,7,77,70,,,,
379,p477_color_image0.jpg,125,5,81,76,,,,
380,P481_color_image0.jpg,125,-4,71,75,,,,
381,P482_color_image0.jpg,125,-3,69,72,,,,
382,P484_color_image0.jpg,125,11,76,65,,,,
383,P485_color_image0.jpg,125,14,78,64,,,,
384,P491_color_image0.jpg,125,-5,72,77,,,,
385,P495_color_image0.jpg,125,7,76,69,,,,
386,P499_color_image0.jpg,125,9,72,63,,,,
387,P501_color_image0.jpg,125,-3,68,71,,,,
388,P505_color_image0.jpg,125,5,73,68,,,,
389,P507_color_image0.jpg,125,-10,66,76,,,,
390,P509_color_image0.jpg,125,-6,72,78,,,,
391,P510_color_image0.jpg,125,-5,72,77,,,,
392,P515_color_image0.jpg,125,8,81,73,,,,
393,P518_color_image0.jpg,125,-7,71,78,,,,
394,P519_color_image0.jpg,125,2,72,70,,,,
395,P521_color_image0.jpg,125,5,69,64,,,,
396,P525_color_image0.jpg,125,-5,71,76,,,,
397,P529_color_image0.jpg,125,-9,59,68,,,,
398,P551_color_image0.jpg,125,0,75,75,,,,
399,P556_color_image0.jpg,125,-2,69,71,,,,
400,P557_color_image0.jpg,125,3,74,71,,,,
401,P564_color_image0.jpg,125,-2,65,67,,,,
402,P565_color_image0.jpg,125,3,66,63,,,,
403,P572_color_image0.jpg,125,-4,74,78,,,,
404,P575_color_image0.jpg,125,14,72,58,,,,
405,P576_color_image0.jpg,125,5,72,67,,,,
406,P577_color_image0.jpg,125,-5,72,77,,,,
407,P578_color_image0.jpg,125,5,74,69,,,,
408,P582_color_image0.jpg,125,0,69,69,,,,
409,P585_color_image0.jpg,125,2,73,71,,,,
410,P586_color_image0.jpg,125,-6,72,78,,,,
411,P592_color_image0.jpg,125,0,69,69,,,,
412,P594_color_image0.jpg,125,-10,68,78,,,,
413,P596_color_image0.jpg,125,5,77,72,,,,
414,P601_color_image0.jpg,125,-6,66,72,,,,
415,P602_color_image0.jpg,125,2,71,69,,,,
416,P605_color_image0.jpg,125,1,72,71,,,,
417,P606_color_image0.jpg,125,-3,74,77,,,,
418,P609_color_image0.jpg,125,4,75,71,,,,
419,P612_color_image0.jpg,125,-1,74,75,,,,
420,P617_color_image0.jpg,125,-1,73,74,,,,
421,P618-1_color_image0.jpg,125,4,78,74,,,,
422,P619_color_image0.jpg,125,0,77,77,,,,
423,P622_color_image0.jpg,125,5,80,75,,,,
424,P632_color_image0.jpg,125,-8,71,79,,,,
425,P635_color_image0.jpg,125,-6,71,77,,,,
426,P636_color_image0.jpg,125,8,81,73,,,,
427,P638_color_image0.jpg,125,-2,71,73,,,,
428,P645_color_image0.jpg,125,-1,75,76,,,,
429,P651_color_image0.jpg,125,0,72,72,,,,
430,P653_color_image0.jpg,125,3,80,77,,,,
431,P673_color_image0.jpg,125,-8,69,77,,,,
432,P674_color_image0.jpg,125,5,78,73,,,,
433,P676_color_image0.jpg,125,7,71,64,,,,
434,P677_color_image0.jpg,125,-6,72,78,,,,
435,P680_color_image0.jpg,125,0,69,69,,,,
436,P681_color_image0.jpg,125,6,78,72,,,,
437,P690_color_image0.jpg,125,6,69,63,,,,
438,P694_color_image0.jpg,125,-11,66,77,,,,
439,P703_color_image0.jpg,125,3,69,66,,,,
440,P704_color_image0.jpg,125,0,72,72,,,,
441,P710_color_image0.jpg,125,-1,69,70,,,,
442,P712_color_image0.jpg,125,-4,64,68,,,,
443,P717_color_image0.jpg,125,3,74,71,,,,
444,P724_color_image0.jpg,125,3,70,67,,,,
445,P728_color_image0.jpg,125,-4,73,77,,,,
446,P742-1_color_image0.jpg,125,2,71,69,,,,
447,P744_color_image0.jpg,125,4,77,73,,,,
448,P745-1_color_image0.jpg,125,-3,68,71,,,,
449,P747_color_image0.jpg,125,15,80,65,,,,
450,P759-1_color_image0.jpg,125,-8,70,78,,,,
451,P766-1_color_image0.jpg,125,15,71,56,,,,
452,P776-1_color_image0.jpg,125,4,72,68,,,,
453,p172_color_image0.jpg,126,-2,71,73,0.165562914,,,
454,p175_color_image0.jpg,126,-3,74,77,,,,
455,P188_color_image0.jpg,126,2,78,76,,,,
456,p191_color_image0.jpg,126,2,72,70,,,,
457,p196_color_image0.jpg,126,-2,69,71,,,,
458,p197_color_image0.jpg,126,-3,74,77,,,,
459,p198_color_image0.jpg,126,-4,68,72,,,,
460,p200_color_image0.jpg,126,-3,74,77,,,,
461,P210_color_image0.jpg,126,0,78,78,,,,
462,p211_color_image0.jpg,126,3,78,75,,,,
463,P220_color_image0.jpg,126,6,76,70,,,,
464,p222_color_image0.jpg,126,3,72,69,,,,
465,p223_color_image0.jpg,126,7,72,65,,,,
466,p230_color_image0.jpg,126,14,72,58,,,,
467,p232-2_color_image0.jpg,126,-3,72,75,,,,
468,p237-1_color_image0.jpg,126,1,74,73,,,,
469,p240_color_image0.jpg,126,-10,69,79,,,,
470,p249_color_image0.jpg,126,-5,71,76,,,,
471,p250_color_image0.jpg,126,2,70,68,,,,
472,p253_color_image0.jpg,126,-4,72,76,,,,
473,p255_color_image0.jpg,126,-1,73,74,,,,
474,p256_color_image0.jpg,126,0,71,71,,,,
475,p260_color_image0.jpg,126,-5,71,76,,,,
476,p261_color_image0.jpg,126,0,72,72,,,,
477,p263_color_image0.jpg,126,3,71,68,,,,
478,P267_color_image0.jpg,126,4,72,68,,,,
479,p272_color_image0.jpg,126,0,72,72,,,,
480,p279_color_image0.jpg,126,9,72,63,,,,
481,P280_color_image0.jpg,126,0,72,72,,,,
482,P282_color_image0.jpg,126,8,80,72,,,,
483,p284_color_image0.jpg,126,-4,71,75,,,,
484,p287_color_image0.jpg,126,0,71,71,,,,
485,p288_color_image0.jpg,126,-9,69,78,,,,
486,p289_color_image0.jpg,126,1,72,71,,,,
487,p302_color_image0.jpg,126,2,74,72,,,,
488,p306_color_image0.jpg,126,7,77,70,,,,
489,p311_color_image0.jpg,126,-6,72,78,,,,
490,P321_color_image0.jpg,126,-3,74,77,,,,
491,p327_color_image0.jpg,126,-5,72,77,,,,
492,p344_color_image0.jpg,126,1,71,70,,,,
493,p345_color_image0.jpg,126,3,70,67,,,,
494,p346-1_color_image0.jpg,126,4,72,68,,,,
495,p347_color_image0.jpg,126,-1,72,73,,,,
496,p351_color_image0.jpg,126,2,72,70,,,,
497,P354_color_image0.jpg,126,-5,72,77,,,,
498,p362_color_image0.jpg,126,3,78,75,,,,
499,p366_color_image0.jpg,126,-6,72,78,,,,
500,p368_color_image0.jpg,126,4,72,68,,,,
501,p378_color_image0.jpg,126,-6,72,78,,,,
502,p386_color_image0.jpg,126,-7,70,77,,,,
503,P395_color_image0.jpg,126,-6,71,77,,,,
504,p397_color_image0.jpg,126,2,74,72,,,,
505,p398_color_image0.jpg,126,-5,71,76,,,,
506,p399_color_image0.jpg,126,0,71,71,,,,
507,p403_color_image0.jpg,126,-4,71,75,,,,
508,p412_color_image0.jpg,126,5,77,72,,,,
509,p415_color_image0.jpg,126,2,72,70,,,,
510,p422_color_image0.jpg,126,14,70,56,,,,
511,p424_color_image0.jpg,126,9,78,69,,,,
512,p425_color_image0.jpg,126,-3,72,75,,,,
513,p430_color_image0.jpg,126,-2,75,77,,,,
514,p431_color_image0.jpg,126,-4,68,72,,,,
515,p432_color_image0.jpg,126,-2,74,76,,,,
516,p435_color_image0.jpg,126,-1,72,73,,,,
517,p438_color_image0.jpg,126,-6,72,78,,,,
518,P439_color_image0.jpg,126,2,72,70,,,,
519,p440_color_image0.jpg,126,-3,74,77,,,,
520,p441_color_image0.jpg,126,6,76,70,,,,
521,p442_color_image0.jpg,126,1,72,71,,,,
522,p445_color_image0.jpg,126,-4,71,75,,,,
523,p452_color_image0.jpg,126,-3,75,78,,,,
524,p454_color_image0.jpg,126,-3,65,68,,,,
525,p462_color_image0.jpg,126,-8,69,77,,,,
526,P467_color_image0.jpg,126,-3,72,75,,,,
527,p469_color_image0.jpg,126,1,78,77,,,,
528,P472_color_image0.jpg,126,-2,74,76,,,,
529,p474_color_image0.jpg,126,2,72,70,,,,
530,p477_color_image0.jpg,126,-4,72,76,,,,
531,P481_color_image0.jpg,126,-4,71,75,,,,
532,P482_color_image0.jpg,126,-1,71,72,,,,
533,P484_color_image0.jpg,126,10,75,65,,,,
534,P485_color_image0.jpg,126,8,72,64,,,,
535,P491_color_image0.jpg,126,-5,72,77,,,,
536,P495_color_image0.jpg,126,9,78,69,,,,
537,P499_color_image0.jpg,126,9,72,63,,,,
538,P501_color_image0.jpg,126,1,72,71,,,,
539,P505_color_image0.jpg,126,6,74,68,,,,
540,P507_color_image0.jpg,126,-5,71,76,,,,
541,P509_color_image0.jpg,126,-7,71,78,,,,
542,P510_color_image0.jpg,126,-5,72,77,,,,
543,P515_color_image0.jpg,126,-4,69,73,,,,
544,P518_color_image0.jpg,126,-8,70,78,,,,
545,P519_color_image0.jpg,126,5,75,70,,,,
546,P521_color_image0.jpg,126,7,71,64,,,,
547,P525_color_image0.jpg,126,-2,74,76,,,,
548,P529_color_image0.jpg,126,3,71,68,,,,
549,P551_color_image0.jpg,126,-3,72,75,,,,
550,P556_color_image0.jpg,126,7,78,71,,,,
551,P557_color_image0.jpg,126,8,79,71,,,,
552,P564_color_image0.jpg,126,2,69,67,,,,
553,P565_color_image0.jpg,126,8,71,63,,,,
554,P572_color_image0.jpg,126,-1,77,78,,,,
555,P575_color_image0.jpg,126,15,73,58,,,,
556,P576_color_image0.jpg,126,5,72,67,,,,
557,P577_color_image0.jpg,126,-5,72,77,,,,
558,P578_color_image0.jpg,126,6,75,69,,,,
559,P582_color_image0.jpg,126,2,71,69,,,,
560,P585_color_image0.jpg,126,1,72,71,,,,
561,P586_color_image0.jpg,126,-3,75,78,,,,
562,P592_color_image0.jpg,126,3,72,69,,,,
563,P594_color_image0.jpg,126,-13,65,78,,,,
564,P596_color_image0.jpg,126,3,75,72,,,,
565,P601_color_image0.jpg,126,-3,69,72,,,,
566,P602_color_image0.jpg,126,5,74,69,,,,
567,P605_color_image0.jpg,126,1,72,71,,,,
568,P606_color_image0.jpg,126,-5,72,77,,,,
569,P609_color_image0.jpg,126,3,74,71,,,,
570,P612_color_image0.jpg,126,-3,72,75,,,,
571,P617_color_image0.jpg,126,2,76,74,,,,
572,P618-1_color_image0.jpg,126,-5,69,74,,,,
573,P619_color_image0.jpg,126,-9,68,77,,,,
574,P622_color_image0.jpg,126,-3,72,75,,,,
575,P632_color_image0.jpg,126,-7,72,79,,,,
576,P635_color_image0.jpg,126,-9,68,77,,,,
577,P636_color_image0.jpg,126,-1,72,73,,,,
578,P638_color_image0.jpg,126,4,77,73,,,,
579,P645_color_image0.jpg,126,-5,71,76,,,,
580,P651_color_image0.jpg,126,-3,69,72,,,,
581,P653_color_image0.jpg,126,-3,74,77,,,,
582,P673_color_image0.jpg,126,-7,70,77,,,,
583,P674_color_image0.jpg,126,4,77,73,,,,
584,P676_color_image0.jpg,126,10,74,64,,,,
585,P677_color_image0.jpg,126,-9,69,78,,,,
586,P680_color_image0.jpg,126,0,69,69,,,,
587,P681_color_image0.jpg,126,2,74,72,,,,
588,P690_color_image0.jpg,126,9,72,63,,,,
589,P694_color_image0.jpg,126,-10,67,77,,,,
590,P703_color_image0.jpg,126,2,68,66,,,,
591,P704_color_image0.jpg,126,2,74,72,,,,
592,P710_color_image0.jpg,126,7,77,70,,,,
593,P712_color_image0.jpg,126,0,68,68,,,,
594,P717_color_image0.jpg,126,1,72,71,,,,
595,P724_color_image0.jpg,126,4,71,67,,,,
596,P728_color_image0.jpg,126,-3,74,77,,,,
597,P742-1_color_image0.jpg,126,3,72,69,,,,
598,P744_color_image0.jpg,126,1,74,73,,,,
599,P745-1_color_image0.jpg,126,0,71,71,,,,
600,P747_color_image0.jpg,126,14,79,65,,,,
601,P759-1_color_image0.jpg,126,-6,72,78,,,,
602,P766-1_color_image0.jpg,126,12,68,56,,,,
603,P776-1_color_image0.jpg,126,3,71,68,,,,
604,p172_color_image0.jpg,99,-7,66,73,-0.079470199,,,
605,p175_color_image0.jpg,99,-5,72,77,,,,
606,P188_color_image0.jpg,99,3,79,76,,,,
607,p191_color_image0.jpg,99,1,71,70,,,,
608,p196_color_image0.jpg,99,-5,66,71,,,,
609,p197_color_image0.jpg,99,-6,71,77,,,,
610,p198_color_image0.jpg,99,-3,69,72,,,,
611,p200_color_image0.jpg,99,1,78,77,,,,
612,P210_color_image0.jpg,99,-1,77,78,,,,
613,p211_color_image0.jpg,99,4,79,75,,,,
614,P220_color_image0.jpg,99,10,80,70,,,,
615,p222_color_image0.jpg,99,3,72,69,,,,
616,p223_color_image0.jpg,99,8,73,65,,,,
617,p230_color_image0.jpg,99,14,72,58,,,,
618,p232-2_color_image0.jpg,99,0,75,75,,,,
619,p237-1_color_image0.jpg,99,-2,71,73,,,,
620,p240_color_image0.jpg,99,-12,67,79,,,,
621,p249_color_image0.jpg,99,-5,71,76,,,,
622,p250_color_image0.jpg,99,3,71,68,,,,
623,p253_color_image0.jpg,99,-7,69,76,,,,
624,p255_color_image0.jpg,99,-2,72,74,,,,
625,p256_color_image0.jpg,99,-2,69,71,,,,
626,p260_color_image0.jpg,99,-11,65,76,,,,
627,p261_color_image0.jpg,99,0,72,72,,,,
628,p263_color_image0.jpg,99,1,69,68,,,,
629,P267_color_image0.jpg,99,4,72,68,,,,
630,p272_color_image0.jpg,99,0,72,72,,,,
631,p279_color_image0.jpg,99,8,71,63,,,,
632,P280_color_image0.jpg,99,-4,68,72,,,,
633,P282_color_image0.jpg,99,0,72,72,,,,
634,p284_color_image0.jpg,99,-3,72,75,,,,
635,p287_color_image0.jpg,99,0,71,71,,,,
636,p288_color_image0.jpg,99,-7,71,78,,,,
637,p289_color_image0.jpg,99,3,74,71,,,,
638,p302_color_image0.jpg,99,-2,70,72,,,,
639,p306_color_image0.jpg,99,5,75,70,,,,
640,p311_color_image0.jpg,99,2,80,78,,,,
641,P321_color_image0.jpg,99,0,77,77,,,,
642,p327_color_image0.jpg,99,-5,72,77,,,,
643,p344_color_image0.jpg,99,1,71,70,,,,
644,p345_color_image0.jpg,99,4,71,67,,,,
645,p346-1_color_image0.jpg,99,-5,63,68,,,,
646,p347_color_image0.jpg,99,7,80,73,,,,
647,p351_color_image0.jpg,99,2,72,70,,,,
648,P354_color_image0.jpg,99,-5,72,77,,,,
649,p362_color_image0.jpg,99,-1,74,75,,,,
650,p366_color_image0.jpg,99,0,78,78,,,,
651,p368_color_image0.jpg,99,4,72,68,,,,
652,p378_color_image0.jpg,99,-6,72,78,,,,
653,p386_color_image0.jpg,99,-6,71,77,,,,
654,P395_color_image0.jpg,99,-6,71,77,,,,
655,p397_color_image0.jpg,99,0,72,72,,,,
656,p398_color_image0.jpg,99,-6,70,76,,,,
657,p399_color_image0.jpg,99,3,74,71,,,,
658,p403_color_image0.jpg,99,-6,69,75,,,,
659,p412_color_image0.jpg,99,7,79,72,,,,
660,p415_color_image0.jpg,99,1,71,70,,,,
661,p422_color_image0.jpg,99,15,71,56,,,,
662,p424_color_image0.jpg,99,10,79,69,,,,
663,p425_color_image0.jpg,99,0,75,75,,,,
664,p430_color_image0.jpg,99,3,80,77,,,,
665,p431_color_image0.jpg,99,-7,65,72,,,,
666,p432_color_image0.jpg,99,-2,74,76,,,,
667,p435_color_image0.jpg,99,-3,70,73,,,,
668,p438_color_image0.jpg,99,-6,72,78,,,,
669,P439_color_image0.jpg,99,10,80,70,,,,
670,p440_color_image0.jpg,99,-2,75,77,,,,
671,p441_color_image0.jpg,99,5,75,70,,,,
672,p442_color_image0.jpg,99,-1,70,71,,,,
673,p445_color_image0.jpg,99,0,75,75,,,,
674,p452_color_image0.jpg,99,-5,73,78,,,,
675,p454_color_image0.jpg,99,-1,67,68,,,,
676,p462_color_image0.jpg,99,-9,68,77,,,,
677,P467_color_image0.jpg,99,-1,74,75,,,,
678,p469_color_image0.jpg,99,-8,69,77,,,,
679,P472_color_image0.jpg,99,-1,75,76,,,,
680,p474_color_image0.jpg,99,1,71,70,,,,
681,p477_color_image0.jpg,99,3,79,76,,,,
682,P481_color_image0.jpg,99,-3,72,75,,,,
683,P482_color_image0.jpg,99,-6,66,72,,,,
684,P484_color_image0.jpg,99,7,72,65,,,,
685,P485_color_image0.jpg,99,15,79,64,,,,
686,P491_color_image0.jpg,99,-14,63,77,,,,
687,P495_color_image0.jpg,99,8,77,69,,,,
688,P499_color_image0.jpg,99,5,68,63,,,,
689,P501_color_image0.jpg,99,-6,65,71,,,,
690,P505_color_image0.jpg,99,8,76,68,,,,
691,P507_color_image0.jpg,99,-5,71,76,,,,
692,P509_color_image0.jpg,99,-10,68,78,,,,
693,P510_color_image0.jpg,99,0,77,77,,,,
694,P515_color_image0.jpg,99,1,74,73,,,,
695,P518_color_image0.jpg,99,-12,66,78,,,,
696,P519_color_image0.jpg,99,8,78,70,,,,
697,P521_color_image0.jpg,99,8,72,64,,,,
698,P525_color_image0.jpg,99,-3,73,76,,,,
699,P529_color_image0.jpg,99,1,69,68,,,,
700,P551_color_image0.jpg,99,-3,72,75,,,,
701,P556_color_image0.jpg,99,0,71,71,,,,
702,P557_color_image0.jpg,99,8,79,71,,,,
703,P564_color_image0.jpg,99,-1,66,67,,,,
704,P565_color_image0.jpg,99,9,72,63,,,,
705,P572_color_image0.jpg,99,-2,76,78,,,,
706,P575_color_image0.jpg,99,14,72,58,,,,
707,P576_color_image0.jpg,99,2,69,67,,,,
708,P577_color_image0.jpg,99,-5,72,77,,,,
709,P578_color_image0.jpg,99,5,74,69,,,,
710,P582_color_image0.jpg,99,6,75,69,,,,
711,P585_color_image0.jpg,99,3,74,71,,,,
712,P586_color_image0.jpg,99,-1,77,78,,,,
713,P592_color_image0.jpg,99,-3,66,69,,,,
714,P594_color_image0.jpg,99,-10,68,78,,,,
715,P596_color_image0.jpg,99,5,77,72,,,,
716,P601_color_image0.jpg,99,-7,65,72,,,,
717,P602_color_image0.jpg,99,5,74,69,,,,
718,P605_color_image0.jpg,99,0,71,71,,,,
719,P606_color_image0.jpg,99,-3,74,77,,,,
720,P609_color_image0.jpg,99,1,72,71,,,,
721,P612_color_image0.jpg,99,-2,73,75,,,,
722,P617_color_image0.jpg,99,7,81,74,,,,
723,P618-1_color_image0.jpg,99,6,80,74,,,,
724,P619_color_image0.jpg,99,-7,70,77,,,,
725,P622_color_image0.jpg,99,-2,73,75,,,,
726,P632_color_image0.jpg,99,-1,78,79,,,,
727,P635_color_image0.jpg,99,-11,66,77,,,,
728,P636_color_image0.jpg,99,-2,71,73,,,,
729,P638_color_image0.jpg,99,4,77,73,,,,
730,P645_color_image0.jpg,99,-8,68,76,,,,
731,P651_color_image0.jpg,99,-2,70,72,,,,
732,P653_color_image0.jpg,99,-2,75,77,,,,
733,P673_color_image0.jpg,99,-7,70,77,,,,
734,P674_color_image0.jpg,99,0,73,73,,,,
735,P676_color_image0.jpg,99,10,74,64,,,,
736,P677_color_image0.jpg,99,-9,69,78,,,,
737,P680_color_image0.jpg,99,-1,68,69,,,,
738,P681_color_image0.jpg,99,2,74,72,,,,
739,P690_color_image0.jpg,99,9,72,63,,,,
740,P694_color_image0.jpg,99,-11,66,77,,,,
741,P703_color_image0.jpg,99,-5,61,66,,,,
742,P704_color_image0.jpg,99,2,74,72,,,,
743,P710_color_image0.jpg,99,4,74,70,,,,
744,P712_color_image0.jpg,99,-2,66,68,,,,
745,P717_color_image0.jpg,99,1,72,71,,,,
746,P724_color_image0.jpg,99,6,73,67,,,,
747,P728_color_image0.jpg,99,0,77,77,,,,
748,P742-1_color_image0.jpg,99,5,74,69,,,,
749,P744_color_image0.jpg,99,-6,67,73,,,,
750,P745-1_color_image0.jpg,99,-5,66,71,,,,
751,P747_color_image0.jpg,99,8,73,65,,,,
752,P759-1_color_image0.jpg,99,-6,72,78,,,,
753,P766-1_color_image0.jpg,99,12,68,56,,,,
754,P776-1_color_image0.jpg,99,6,74,68,,,,
755,p172_color_image0.jpg,127,-3,70,73,-0.238410596,,,
756,p175_color_image0.jpg,127,-2,75,77,,,,
757,P188_color_image0.jpg,127,-4,72,76,,,,
758,p191_color_image0.jpg,127,1,71,70,,,,
759,p196_color_image0.jpg,127,-5,66,71,,,,
760,p197_color_image0.jpg,127,-6,71,77,,,,
761,p198_color_image0.jpg,127,-5,67,72,,,,
762,p200_color_image0.jpg,127,-5,72,77,,,,
763,P210_color_image0.jpg,127,-3,75,78,,,,
764,p211_color_image0.jpg,127,-4,71,75,,,,
765,P220_color_image0.jpg,127,8,78,70,,,,
766,p222_color_image0.jpg,127,2,71,69,,,,
767,p223_color_image0.jpg,127,7,72,65,,,,
768,p230_color_image0.jpg,127,13,71,58,,,,
769,p232-2_color_image0.jpg,127,-1,74,75,,,,
770,p237-1_color_image0.jpg,127,-2,71,73,,,,
771,p240_color_image0.jpg,127,-11,68,79,,,,
772,p249_color_image0.jpg,127,-2,74,76,,,,
773,p250_color_image0.jpg,127,0,68,68,,,,
774,p253_color_image0.jpg,127,-4,72,76,,,,
775,p255_color_image0.jpg,127,-3,71,74,,,,
776,p256_color_image0.jpg,127,1,72,71,,,,
777,p260_color_image0.jpg,127,-8,68,76,,,,
778,p261_color_image0.jpg,127,-1,71,72,,,,
779,p263_color_image0.jpg,127,2,70,68,,,,
780,P267_color_image0.jpg,127,4,72,68,,,,
781,p272_color_image0.jpg,127,-1,71,72,,,,
782,p279_color_image0.jpg,127,9,72,63,,,,
783,P280_color_image0.jpg,127,-3,69,72,,,,
784,P282_color_image0.jpg,127,6,78,72,,,,
785,p284_color_image0.jpg,127,-4,71,75,,,,
786,p287_color_image0.jpg,127,1,72,71,,,,
787,p288_color_image0.jpg,127,-7,71,78,,,,
788,p289_color_image0.jpg,127,7,78,71,,,,
789,p302_color_image0.jpg,127,6,78,72,,,,
790,p306_color_image0.jpg,127,4,74,70,,,,
791,p311_color_image0.jpg,127,-2,76,78,,,,
792,P321_color_image0.jpg,127,1,78,77,,,,
793,p327_color_image0.jpg,127,-3,74,77,,,,
794,p344_color_image0.jpg,127,1,71,70,,,,
795,p345_color_image0.jpg,127,2,69,67,,,,
796,p346-1_color_image0.jpg,127,1,69,68,,,,
797,p347_color_image0.jpg,127,-3,70,73,,,,
798,p351_color_image0.jpg,127,1,71,70,,,,
799,P354_color_image0.jpg,127,-5,72,77,,,,
800,p362_color_image0.jpg,127,-4,71,75,,,,
801,p366_color_image0.jpg,127,-1,77,78,,,,
802,p368_color_image0.jpg,127,3,71,68,,,,
803,p378_color_image0.jpg,127,-7,71,78,,,,
804,p386_color_image0.jpg,127,-8,69,77,,,,
805,P395_color_image0.jpg,127,-10,67,77,,,,
806,p397_color_image0.jpg,127,0,72,72,,,,
807,p398_color_image0.jpg,127,-5,71,76,,,,
808,p399_color_image0.jpg,127,0,71,71,,,,
809,p403_color_image0.jpg,127,-1,74,75,,,,
810,p412_color_image0.jpg,127,0,72,72,,,,
811,p415_color_image0.jpg,127,2,72,70,,,,
812,p422_color_image0.jpg,127,15,71,56,,,,
813,p424_color_image0.jpg,127,2,71,69,,,,
814,p425_color_image0.jpg,127,-1,74,75,,,,
815,p430_color_image0.jpg,127,-6,71,77,,,,
816,p431_color_image0.jpg,127,-4,68,72,,,,
817,p432_color_image0.jpg,127,-2,74,76,,,,
818,p435_color_image0.jpg,127,-4,69,73,,,,
819,p438_color_image0.jpg,127,-6,72,78,,,,
820,P439_color_image0.jpg,127,3,73,70,,,,
821,p440_color_image0.jpg,127,-6,71,77,,,,
822,p441_color_image0.jpg,127,3,73,70,,,,
823,p442_color_image0.jpg,127,1,72,71,,,,
824,p445_color_image0.jpg,127,-9,66,75,,,,
825,p452_color_image0.jpg,127,-4,74,78,,,,
826,p454_color_image0.jpg,127,-2,66,68,,,,
827,p462_color_image0.jpg,127,-7,70,77,,,,
828,P467_color_image0.jpg,127,0,75,75,,,,
829,p469_color_image0.jpg,127,-6,71,77,,,,
830,P472_color_image0.jpg,127,-1,75,76,,,,
831,p474_color_image0.jpg,127,2,72,70,,,,
832,p477_color_image0.jpg,127,-1,75,76,,,,
833,P481_color_image0.jpg,127,2,77,75,,,,
834,P482_color_image0.jpg,127,-2,70,72,,,,
835,P484_color_image0.jpg,127,7,72,65,,,,
836,P485_color_image0.jpg,127,14,78,64,,,,
837,P491_color_image0.jpg,127,-5,72,77,,,,
838,P495_color_image0.jpg,127,16,85,69,,,,
839,P499_color_image0.jpg,127,8,71,63,,,,
840,P501_color_image0.jpg,127,1,72,71,,,,
841,P505_color_image0.jpg,127,4,72,68,,,,
842,P507_color_image0.jpg,127,-5,71,76,,,,
843,P509_color_image0.jpg,127,-7,71,78,,,,
844,P510_color_image0.jpg,127,-6,71,77,,,,
845,P515_color_image0.jpg,127,10,83,73,,,,
846,P518_color_image0.jpg,127,-9,69,78,,,,
847,P519_color_image0.jpg,127,3,73,70,,,,
848,P521_color_image0.jpg,127,7,71,64,,,,
849,P525_color_image0.jpg,127,-4,72,76,,,,
850,P529_color_image0.jpg,127,2,70,68,,,,
851,P551_color_image0.jpg,127,-1,74,75,,,,
852,P556_color_image0.jpg,127,1,72,71,,,,
853,P557_color_image0.jpg,127,6,77,71,,,,
854,P564_color_image0.jpg,127,-2,65,67,,,,
855,P565_color_image0.jpg,127,7,70,63,,,,
856,P572_color_image0.jpg,127,0,78,78,,,,
857,P575_color_image0.jpg,127,14,72,58,,,,
858,P576_color_image0.jpg,127,3,70,67,,,,
859,P577_color_image0.jpg,127,-5,72,77,,,,
860,P578_color_image0.jpg,127,6,75,69,,,,
861,P582_color_image0.jpg,127,13,82,69,,,,
862,P585_color_image0.jpg,127,3,74,71,,,,
863,P586_color_image0.jpg,127,-7,71,78,,,,
864,P592_color_image0.jpg,127,3,72,69,,,,
865,P594_color_image0.jpg,127,-13,65,78,,,,
866,P596_color_image0.jpg,127,0,72,72,,,,
867,P601_color_image0.jpg,127,0,72,72,,,,
868,P602_color_image0.jpg,127,8,77,69,,,,
869,P605_color_image0.jpg,127,1,72,71,,,,
870,P606_color_image0.jpg,127,-5,72,77,,,,
871,P609_color_image0.jpg,127,4,75,71,,,,
872,P612_color_image0.jpg,127,-3,72,75,,,,
873,P617_color_image0.jpg,127,2,76,74,,,,
874,P618-1_color_image0.jpg,127,0,74,74,,,,
875,P619_color_image0.jpg,127,-8,69,77,,,,
876,P622_color_image0.jpg,127,1,76,75,,,,
877,P632_color_image0.jpg,127,-11,68,79,,,,
878,P635_color_image0.jpg,127,-7,70,77,,,,
879,P636_color_image0.jpg,127,-2,71,73,,,,
880,P638_color_image0.jpg,127,-1,72,73,,,,
881,P645_color_image0.jpg,127,-5,71,76,,,,
882,P651_color_image0.jpg,127,-3,69,72,,,,
883,P653_color_image0.jpg,127,-4,73,77,,,,
884,P673_color_image0.jpg,127,-6,71,77,,,,
885,P674_color_image0.jpg,127,7,80,73,,,,
886,P676_color_image0.jpg,127,5,69,64,,,,
887,P677_color_image0.jpg,127,-10,68,78,,,,
888,P680_color_image0.jpg,127,-1,68,69,,,,
889,P681_color_image0.jpg,127,0,72,72,,,,
890,P690_color_image0.jpg,127,9,72,63,,,,
891,P694_color_image0.jpg,127,-9,68,77,,,,
892,P703_color_image0.jpg,127,6,72,66,,,,
893,P704_color_image0.jpg,127,-6,66,72,,,,
894,P710_color_image0.jpg,127,2,72,70,,,,
895,P712_color_image0.jpg,127,1,69,68,,,,
896,P717_color_image0.jpg,127,1,72,71,,,,
897,P724_color_image0.jpg,127,3,70,67,,,,
898,P728_color_image0.jpg,127,0,77,77,,,,
899,P742-1_color_image0.jpg,127,2,71,69,,,,
900,P744_color_image0.jpg,127,-1,72,73,,,,
901,P745-1_color_image0.jpg,127,-3,68,71,,,,
902,P747_color_image0.jpg,127,10,75,65,,,,
903,P759-1_color_image0.jpg,127,-9,69,78,,,,
904,P766-1_color_image0.jpg,127,12,68,56,,,,
905,P776-1_color_image0.jpg,127,4,72,68,,,,
906,p172_color_image0.jpg,128,-8,65,73,0.165562914,,,
907,p175_color_image0.jpg,128,-1,76,77,,,,
908,P188_color_image0.jpg,128,-1,75,76,,,,
909,p191_color_image0.jpg,128,1,71,70,,,,
910,p196_color_image0.jpg,128,-8,63,71,,,,
911,p197_color_image0.jpg,128,-5,72,77,,,,
912,p198_color_image0.jpg,128,-6,66,72,,,,
913,p200_color_image0.jpg,128,-2,75,77,,,,
914,P210_color_image0.jpg,128,1,79,78,,,,
915,p211_color_image0.jpg,128,4,79,75,,,,
916,P220_color_image0.jpg,128,5,75,70,,,,
917,p222_color_image0.jpg,128,4,73,69,,,,
918,p223_color_image0.jpg,128,6,71,65,,,,
919,p230_color_image0.jpg,128,13,71,58,,,,
920,p232-2_color_image0.jpg,128,-1,74,75,,,,
921,p237-1_color_image0.jpg,128,-6,67,73,,,,
922,p240_color_image0.jpg,128,-11,68,79,,,,
923,p249_color_image0.jpg,128,-2,74,76,,,,
924,p250_color_image0.jpg,128,0,68,68,,,,
925,p253_color_image0.jpg,128,-5,71,76,,,,
926,p255_color_image0.jpg,128,-3,71,74,,,,
927,p256_color_image0.jpg,128,1,72,71,,,,
928,p260_color_image0.jpg,128,4,80,76,,,,
929,p261_color_image0.jpg,128,-3,69,72,,,,
930,p263_color_image0.jpg,128,3,71,68,,,,
931,P267_color_image0.jpg,128,6,74,68,,,,
932,p272_color_image0.jpg,128,-3,69,72,,,,
933,p279_color_image0.jpg,128,9,72,63,,,,
934,P280_color_image0.jpg,128,-1,71,72,,,,
935,P282_color_image0.jpg,128,7,79,72,,,,
936,p284_color_image0.jpg,128,-4,71,75,,,,
937,p287_color_image0.jpg,128,4,75,71,,,,
938,p288_color_image0.jpg,128,-9,69,78,,,,
939,p289_color_image0.jpg,128,7,78,71,,,,
940,p302_color_image0.jpg,128,7,79,72,,,,
941,p306_color_image0.jpg,128,2,72,70,,,,
942,p311_color_image0.jpg,128,-3,75,78,,,,
943,P321_color_image0.jpg,128,-2,75,77,,,,
944,p327_color_image0.jpg,128,-11,66,77,,,,
945,p344_color_image0.jpg,128,1,71,70,,,,
946,p345_color_image0.jpg,128,1,68,67,,,,
947,p346-1_color_image0.jpg,128,-3,65,68,,,,
948,p347_color_image0.jpg,128,-4,69,73,,,,
949,p351_color_image0.jpg,128,1,71,70,,,,
950,P354_color_image0.jpg,128,-5,72,77,,,,
951,p362_color_image0.jpg,128,-6,69,75,,,,
952,p366_color_image0.jpg,128,-5,73,78,,,,
953,p368_color_image0.jpg,128,6,74,68,,,,
954,p378_color_image0.jpg,128,-12,66,78,,,,
955,p386_color_image0.jpg,128,-8,69,77,,,,
956,P395_color_image0.jpg,128,-5,72,77,,,,
957,p397_color_image0.jpg,128,-1,71,72,,,,
958,p398_color_image0.jpg,128,-5,71,76,,,,
959,p399_color_image0.jpg,128,0,71,71,,,,
960,p403_color_image0.jpg,128,2,77,75,,,,
961,p412_color_image0.jpg,128,8,80,72,,,,
962,p415_color_image0.jpg,128,4,74,70,,,,
963,p422_color_image0.jpg,128,13,69,56,,,,
964,p424_color_image0.jpg,128,8,77,69,,,,
965,p425_color_image0.jpg,128,3,78,75,,,,
966,p430_color_image0.jpg,128,-6,71,77,,,,
967,p431_color_image0.jpg,128,-4,68,72,,,,
968,p432_color_image0.jpg,128,-2,74,76,,,,
969,p435_color_image0.jpg,128,6,79,73,,,,
970,p438_color_image0.jpg,128,-9,69,78,,,,
971,P439_color_image0.jpg,128,3,73,70,,,,
972,p440_color_image0.jpg,128,-6,71,77,,,,
973,p441_color_image0.jpg,128,2,72,70,,,,
974,p442_color_image0.jpg,128,4,75,71,,,,
975,p445_color_image0.jpg,128,5,80,75,,,,
976,p452_color_image0.jpg,128,-4,74,78,,,,
977,p454_color_image0.jpg,128,-6,62,68,,,,
978,p462_color_image0.jpg,128,-6,71,77,,,,
979,P467_color_image0.jpg,128,1,76,75,,,,
980,p469_color_image0.jpg,128,2,79,77,,,,
981,P472_color_image0.jpg,128,-2,74,76,,,,
982,p474_color_image0.jpg,128,2,72,70,,,,
983,p477_color_image0.jpg,128,7,83,76,,,,
984,P481_color_image0.jpg,128,-1,74,75,,,,
985,P482_color_image0.jpg,128,-7,65,72,,,,
986,P484_color_image0.jpg,128,9,74,65,,,,
987,P485_color_image0.jpg,128,17,81,64,,,,
988,P491_color_image0.jpg,128,-5,72,77,,,,
989,P495_color_image0.jpg,128,17,86,69,,,,
990,P499_color_image0.jpg,128,8,71,63,,,,
991,P501_color_image0.jpg,128,-11,60,71,,,,
992,P505_color_image0.jpg,128,9,77,68,,,,
993,P507_color_image0.jpg,128,-5,71,76,,,,
994,P509_color_image0.jpg,128,-5,73,78,,,,
995,P510_color_image0.jpg,128,0,77,77,,,,
996,P515_color_image0.jpg,128,9,82,73,,,,
997,P518_color_image0.jpg,128,-7,71,78,,,,
998,P519_color_image0.jpg,128,7,77,70,,,,
999,P521_color_image0.jpg,128,5,69,64,,,,
1000,P525_color_image0.jpg,128,-5,71,76,,,,
1001,P529_color_image0.jpg,128,-3,65,68,,,,
1002,P551_color_image0.jpg,128,-1,74,75,,,,
1003,P556_color_image0.jpg,128,-3,68,71,,,,
1004,P557_color_image0.jpg,128,6,77,71,,,,
1005,P564_color_image0.jpg,128,-4,63,67,,,,
1006,P565_color_image0.jpg,128,5,68,63,,,,
1007,P572_color_image0.jpg,128,-2,76,78,,,,
1008,P575_color_image0.jpg,128,14,72,58,,,,
1009,P576_color_image0.jpg,128,4,71,67,,,,
1010,P577_color_image0.jpg,128,-3,74,77,,,,
1011,P578_color_image0.jpg,128,8,77,69,,,,
1012,P582_color_image0.jpg,128,10,79,69,,,,
1013,P585_color_image0.jpg,128,3,74,71,,,,
1014,P586_color_image0.jpg,128,-6,72,78,,,,
1015,P592_color_image0.jpg,128,2,71,69,,,,
1016,P594_color_image0.jpg,128,-4,74,78,,,,
1017,P596_color_image0.jpg,128,1,73,72,,,,
1018,P601_color_image0.jpg,128,-3,69,72,,,,
1019,P602_color_image0.jpg,128,9,78,69,,,,
1020,P605_color_image0.jpg,128,0,71,71,,,,
1021,P606_color_image0.jpg,128,-5,72,77,,,,
1022,P609_color_image0.jpg,128,2,73,71,,,,
1023,P612_color_image0.jpg,128,-4,71,75,,,,
1024,P617_color_image0.jpg,128,3,77,74,,,,
1025,P618-1_color_image0.jpg,128,4,78,74,,,,
1026,P619_color_image0.jpg,128,1,78,77,,,,
1027,P622_color_image0.jpg,128,2,77,75,,,,
1028,P632_color_image0.jpg,128,-8,71,79,,,,
1029,P635_color_image0.jpg,128,-12,65,77,,,,
1030,P636_color_image0.jpg,128,-1,72,73,,,,
1031,P638_color_image0.jpg,128,4,77,73,,,,
1032,P645_color_image0.jpg,128,-7,69,76,,,,
1033,P651_color_image0.jpg,128,-4,68,72,,,,
1034,P653_color_image0.jpg,128,-12,65,77,,,,
1035,P673_color_image0.jpg,128,-8,69,77,,,,
1036,P674_color_image0.jpg,128,7,80,73,,,,
1037,P676_color_image0.jpg,128,6,70,64,,,,
1038,P677_color_image0.jpg,128,-7,71,78,,,,
1039,P680_color_image0.jpg,128,-1,68,69,,,,
1040,P681_color_image0.jpg,128,1,73,72,,,,
1041,P690_color_image0.jpg,128,0,63,63,,,,
1042,P694_color_image0.jpg,128,-11,66,77,,,,
1043,P703_color_image0.jpg,128,3,69,66,,,,
1044,P704_color_image0.jpg,128,2,74,72,,,,
1045,P710_color_image0.jpg,128,-2,68,70,,,,
1046,P712_color_image0.jpg,128,3,71,68,,,,
1047,P717_color_image0.jpg,128,1,72,71,,,,
1048,P724_color_image0.jpg,128,5,72,67,,,,
1049,P728_color_image0.jpg,128,0,77,77,,,,
1050,P742-1_color_image0.jpg,128,11,80,69,,,,
1051,P744_color_image0.jpg,128,1,74,73,,,,
1052,P745-1_color_image0.jpg,128,-6,65,71,,,,
1053,P747_color_image0.jpg,128,7,72,65,,,,
1054,P759-1_color_image0.jpg,128,-9,69,78,,,,
1055,P766-1_color_image0.jpg,128,12,68,56,,,,
1056,P776-1_color_image0.jpg,128,10,78,68,,,,
1057,p172_color_image0.jpg,108,-8,65,73,-0.344370861,,,
1058,p175_color_image0.jpg,108,3,80,77,,,,
1059,P188_color_image0.jpg,108,3,79,76,,,,
1060,p191_color_image0.jpg,108,-6,64,70,,,,
1061,p196_color_image0.jpg,108,-9,62,71,,,,
1062,p197_color_image0.jpg,108,-6,71,77,,,,
1063,p198_color_image0.jpg,108,-4,68,72,,,,
1064,p200_color_image0.jpg,108,-5,72,77,,,,
1065,P210_color_image0.jpg,108,-2,76,78,,,,
1066,p211_color_image0.jpg,108,3,78,75,,,,
1067,P220_color_image0.jpg,108,10,80,70,,,,
1068,p222_color_image0.jpg,108,3,72,69,,,,
1069,p223_color_image0.jpg,108,7,72,65,,,,
1070,p230_color_image0.jpg,108,13,71,58,,,,
1071,p232-2_color_image0.jpg,108,-3,72,75,,,,
1072,p237-1_color_image0.jpg,108,4,77,73,,,,
1073,p240_color_image0.jpg,108,-12,67,79,,,,
1074,p249_color_image0.jpg,108,-5,71,76,,,,
1075,p250_color_image0.jpg,108,1,69,68,,,,
1076,p253_color_image0.jpg,108,-6,70,76,,,,
1077,p255_color_image0.jpg,108,8,82,74,,,,
1078,p256_color_image0.jpg,108,0,71,71,,,,
1079,p260_color_image0.jpg,108,-11,65,76,,,,
1080,p261_color_image0.jpg,108,1,73,72,,,,
1081,p263_color_image0.jpg,108,3,71,68,,,,
1082,P267_color_image0.jpg,108,4,72,68,,,,
1083,p272_color_image0.jpg,108,-1,71,72,,,,
1084,p279_color_image0.jpg,108,9,72,63,,,,
1085,P280_color_image0.jpg,108,-1,71,72,,,,
1086,P282_color_image0.jpg,108,6,78,72,,,,
1087,p284_color_image0.jpg,108,-4,71,75,,,,
1088,p287_color_image0.jpg,108,0,71,71,,,,
1089,p288_color_image0.jpg,108,-10,68,78,,,,
1090,p289_color_image0.jpg,108,1,72,71,,,,
1091,p302_color_image0.jpg,108,8,80,72,,,,
1092,p306_color_image0.jpg,108,5,75,70,,,,
1093,p311_color_image0.jpg,108,-4,74,78,,,,
1094,P321_color_image0.jpg,108,-5,72,77,,,,
1095,p327_color_image0.jpg,108,-5,72,77,,,,
1096,p344_color_image0.jpg,108,8,78,70,,,,
1097,p345_color_image0.jpg,108,2,69,67,,,,
1098,p346-1_color_image0.jpg,108,-8,60,68,,,,
1099,p347_color_image0.jpg,108,0,73,73,,,,
1100,p351_color_image0.jpg,108,1,71,70,,,,
1101,P354_color_image0.jpg,108,-6,71,77,,,,
1102,p362_color_image0.jpg,108,8,83,75,,,,
1103,p366_color_image0.jpg,108,-3,75,78,,,,
1104,p368_color_image0.jpg,108,3,71,68,,,,
1105,p378_color_image0.jpg,108,-7,71,78,,,,
1106,p386_color_image0.jpg,108,-8,69,77,,,,
1107,P395_color_image0.jpg,108,-11,66,77,,,,
1108,p397_color_image0.jpg,108,4,76,72,,,,
1109,p398_color_image0.jpg,108,-7,69,76,,,,
1110,p399_color_image0.jpg,108,-4,67,71,,,,
1111,p403_color_image0.jpg,108,-6,69,75,,,,
1112,p412_color_image0.jpg,108,4,76,72,,,,
1113,p415_color_image0.jpg,108,5,75,70,,,,
1114,p422_color_image0.jpg,108,15,71,56,,,,
1115,p424_color_image0.jpg,108,8,77,69,,,,
1116,p425_color_image0.jpg,108,-3,72,75,,,,
1117,p430_color_image0.jpg,108,1,78,77,,,,
1118,p431_color_image0.jpg,108,-6,66,72,,,,
1119,p432_color_image0.jpg,108,-2,74,76,,,,
1120,p435_color_image0.jpg,108,-3,70,73,,,,
1121,p438_color_image0.jpg,108,-6,72,78,,,,
1122,P439_color_image0.jpg,108,11,81,70,,,,
1123,p440_color_image0.jpg,108,0,77,77,,,,
1124,p441_color_image0.jpg,108,2,72,70,,,,
1125,p442_color_image0.jpg,108,-5,66,71,,,,
1126,p445_color_image0.jpg,108,-3,72,75,,,,
1127,p452_color_image0.jpg,108,-4,74,78,,,,
1128,p454_color_image0.jpg,108,-2,66,68,,,,
1129,p462_color_image0.jpg,108,-9,68,77,,,,
1130,P467_color_image0.jpg,108,-1,74,75,,,,
1131,p469_color_image0.jpg,108,-6,71,77,,,,
1132,P472_color_image0.jpg,108,-2,74,76,,,,
1133,p474_color_image0.jpg,108,2,72,70,,,,
1134,p477_color_image0.jpg,108,6,82,76,,,,
1135,P481_color_image0.jpg,108,0,75,75,,,,
1136,P482_color_image0.jpg,108,-9,63,72,,,,
1137,P484_color_image0.jpg,108,3,68,65,,,,
1138,P485_color_image0.jpg,108,13,77,64,,,,
1139,P491_color_image0.jpg,108,-5,72,77,,,,
1140,P495_color_image0.jpg,108,9,78,69,,,,
1141,P499_color_image0.jpg,108,6,69,63,,,,
1142,P501_color_image0.jpg,108,-9,62,71,,,,
1143,P505_color_image0.jpg,108,10,78,68,,,,
1144,P507_color_image0.jpg,108,-5,71,76,,,,
1145,P509_color_image0.jpg,108,2,80,78,,,,
1146,P510_color_image0.jpg,108,-6,71,77,,,,
1147,P515_color_image0.jpg,108,5,78,73,,,,
1148,P518_color_image0.jpg,108,-10,68,78,,,,
1149,P519_color_image0.jpg,108,8,78,70,,,,
1150,P521_color_image0.jpg,108,5,69,64,,,,
1151,P525_color_image0.jpg,108,-10,66,76,,,,
1152,P529_color_image0.jpg,108,1,69,68,,,,
1153,P551_color_image0.jpg,108,-3,72,75,,,,
1154,P556_color_image0.jpg,108,10,81,71,,,,
1155,P557_color_image0.jpg,108,6,77,71,,,,
1156,P564_color_image0.jpg,108,1,68,67,,,,
1157,P565_color_image0.jpg,108,9,72,63,,,,
1158,P572_color_image0.jpg,108,-1,77,78,,,,
1159,P575_color_image0.jpg,108,12,70,58,,,,
1160,P576_color_image0.jpg,108,4,71,67,,,,
1161,P577_color_image0.jpg,108,-8,69,77,,,,
1162,P578_color_image0.jpg,108,7,76,69,,,,
1163,P582_color_image0.jpg,108,9,78,69,,,,
1164,P585_color_image0.jpg,108,3,74,71,,,,
1165,P586_color_image0.jpg,108,2,80,78,,,,
1166,P592_color_image0.jpg,108,0,69,69,,,,
1167,P594_color_image0.jpg,108,-16,62,78,,,,
1168,P596_color_image0.jpg,108,9,81,72,,,,
1169,P601_color_image0.jpg,108,-11,61,72,,,,
1170,P602_color_image0.jpg,108,3,72,69,,,,
1171,P605_color_image0.jpg,108,-2,69,71,,,,
1172,P606_color_image0.jpg,108,-5,72,77,,,,
1173,P609_color_image0.jpg,108,2,73,71,,,,
1174,P612_color_image0.jpg,108,-3,72,75,,,,
1175,P617_color_image0.jpg,108,0,74,74,,,,
1176,P618-1_color_image0.jpg,108,6,80,74,,,,
1177,P619_color_image0.jpg,108,-7,70,77,,,,
1178,P622_color_image0.jpg,108,-1,74,75,,,,
1179,P632_color_image0.jpg,108,-4,75,79,,,,
1180,P635_color_image0.jpg,108,-12,65,77,,,,
1181,P636_color_image0.jpg,108,-4,69,73,,,,
1182,P638_color_image0.jpg,108,0,73,73,,,,
1183,P645_color_image0.jpg,108,-10,66,76,,,,
1184,P651_color_image0.jpg,108,0,72,72,,,,
1185,P653_color_image0.jpg,108,-5,72,77,,,,
1186,P673_color_image0.jpg,108,-9,68,77,,,,
1187,P674_color_image0.jpg,108,7,80,73,,,,
1188,P676_color_image0.jpg,108,7,71,64,,,,
1189,P677_color_image0.jpg,108,-9,69,78,,,,
1190,P680_color_image0.jpg,108,-2,67,69,,,,
1191,P681_color_image0.jpg,108,3,75,72,,,,
1192,P690_color_image0.jpg,108,4,67,63,,,,
1193,P694_color_image0.jpg,108,-12,65,77,,,,
1194,P703_color_image0.jpg,108,-1,65,66,,,,
1195,P704_color_image0.jpg,108,1,73,72,,,,
1196,P710_color_image0.jpg,108,3,73,70,,,,
1197,P712_color_image0.jpg,108,-2,66,68,,,,
1198,P717_color_image0.jpg,108,2,73,71,,,,
1199,P724_color_image0.jpg,108,9,76,67,,,,
1200,P728_color_image0.jpg,108,-5,72,77,,,,
1201,P742-1_color_image0.jpg,108,2,71,69,,,,
1202,P744_color_image0.jpg,108,-7,66,73,,,,
1203,P745-1_color_image0.jpg,108,-7,64,71,,,,
1204,P747_color_image0.jpg,108,6,71,65,,,,
1205,P759-1_color_image0.jpg,108,-7,71,78,,,,
1206,P766-1_color_image0.jpg,108,10,66,56,,,,
1207,P776-1_color_image0.jpg,108,3,71,68,,,,
1208,p172_color_image0.jpg,112,-6,67,73,0.622516556,,,
1209,p175_color_image0.jpg,112,9,86,77,,,,
1210,P188_color_image0.jpg,112,2,78,76,,,,
1211,p191_color_image0.jpg,112,2,72,70,,,,
1212,p196_color_image0.jpg,112,-8,63,71,,,,
1213,p197_color_image0.jpg,112,8,85,77,,,,
1214,p198_color_image0.jpg,112,-3,69,72,,,,
1215,p200_color_image0.jpg,112,1,78,77,,,,
1216,P210_color_image0.jpg,112,1,79,78,,,,
1217,p211_color_image0.jpg,112,3,78,75,,,,
1218,P220_color_image0.jpg,112,8,78,70,,,,
1219,p222_color_image0.jpg,112,10,79,69,,,,
1220,p223_color_image0.jpg,112,-3,62,65,,,,
1221,p230_color_image0.jpg,112,16,74,58,,,,
1222,p232-2_color_image0.jpg,112,-1,74,75,,,,
1223,p237-1_color_image0.jpg,112,-2,71,73,,,,
1224,p240_color_image0.jpg,112,-9,70,79,,,,
1225,p249_color_image0.jpg,112,-5,71,76,,,,
1226,p250_color_image0.jpg,112,1,69,68,,,,
1227,p253_color_image0.jpg,112,-4,72,76,,,,
1228,p255_color_image0.jpg,112,-2,72,74,,,,
1229,p256_color_image0.jpg,112,0,71,71,,,,
1230,p260_color_image0.jpg,112,9,85,76,,,,
1231,p261_color_image0.jpg,112,-1,71,72,,,,
1232,p263_color_image0.jpg,112,-2,66,68,,,,
1233,P267_color_image0.jpg,112,4,72,68,,,,
1234,p272_color_image0.jpg,112,-1,71,72,,,,
1235,p279_color_image0.jpg,112,9,72,63,,,,
1236,P280_color_image0.jpg,112,-4,68,72,,,,
1237,P282_color_image0.jpg,112,2,74,72,,,,
1238,p284_color_image0.jpg,112,-4,71,75,,,,
1239,p287_color_image0.jpg,112,-2,69,71,,,,
1240,p288_color_image0.jpg,112,-10,68,78,,,,
1241,p289_color_image0.jpg,112,1,72,71,,,,
1242,p302_color_image0.jpg,112,-1,71,72,,,,
1243,p306_color_image0.jpg,112,3,73,70,,,,
1244,p311_color_image0.jpg,112,-5,73,78,,,,
1245,P321_color_image0.jpg,112,-2,75,77,,,,
1246,p327_color_image0.jpg,112,-7,70,77,,,,
1247,p344_color_image0.jpg,112,2,72,70,,,,
1248,p345_color_image0.jpg,112,3,70,67,,,,
1249,p346-1_color_image0.jpg,112,-5,63,68,,,,
1250,p347_color_image0.jpg,112,-1,72,73,,,,
1251,p351_color_image0.jpg,112,1,71,70,,,,
1252,P354_color_image0.jpg,112,-4,73,77,,,,
1253,p362_color_image0.jpg,112,-4,71,75,,,,
1254,p366_color_image0.jpg,112,-7,71,78,,,,
1255,p368_color_image0.jpg,112,3,71,68,,,,
1256,p378_color_image0.jpg,112,-6,72,78,,,,
1257,p386_color_image0.jpg,112,-6,71,77,,,,
1258,P395_color_image0.jpg,112,-1,76,77,,,,
1259,p397_color_image0.jpg,112,2,74,72,,,,
1260,p398_color_image0.jpg,112,-6,70,76,,,,
1261,p399_color_image0.jpg,112,-2,69,71,,,,
1262,p403_color_image0.jpg,112,-3,72,75,,,,
1263,p412_color_image0.jpg,112,3,75,72,,,,
1264,p415_color_image0.jpg,112,2,72,70,,,,
1265,p422_color_image0.jpg,112,16,72,56,,,,
1266,p424_color_image0.jpg,112,9,78,69,,,,
1267,p425_color_image0.jpg,112,-2,73,75,,,,
1268,p430_color_image0.jpg,112,4,81,77,,,,
1269,p431_color_image0.jpg,112,1,73,72,,,,
1270,p432_color_image0.jpg,112,-2,74,76,,,,
1271,p435_color_image0.jpg,112,1,74,73,,,,
1272,p438_color_image0.jpg,112,-6,72,78,,,,
1273,P439_color_image0.jpg,112,10,80,70,,,,
1274,p440_color_image0.jpg,112,-5,72,77,,,,
1275,p441_color_image0.jpg,112,2,72,70,,,,
1276,p442_color_image0.jpg,112,5,76,71,,,,
1277,p445_color_image0.jpg,112,-2,73,75,,,,
1278,p452_color_image0.jpg,112,-4,74,78,,,,
1279,p454_color_image0.jpg,112,3,71,68,,,,
1280,p462_color_image0.jpg,112,-5,72,77,,,,
1281,P467_color_image0.jpg,112,-3,72,75,,,,
1282,p469_color_image0.jpg,112,-3,74,77,,,,
1283,P472_color_image0.jpg,112,-2,74,76,,,,
1284,p474_color_image0.jpg,112,2,72,70,,,,
1285,p477_color_image0.jpg,112,8,84,76,,,,
1286,P481_color_image0.jpg,112,-3,72,75,,,,
1287,P482_color_image0.jpg,112,0,72,72,,,,
1288,P484_color_image0.jpg,112,9,74,65,,,,
1289,P485_color_image0.jpg,112,13,77,64,,,,
1290,P491_color_image0.jpg,112,-6,71,77,,,,
1291,P495_color_image0.jpg,112,5,74,69,,,,
1292,P499_color_image0.jpg,112,9,72,63,,,,
1293,P501_color_image0.jpg,112,-7,64,71,,,,
1294,P505_color_image0.jpg,112,10,78,68,,,,
1295,P507_color_image0.jpg,112,-5,71,76,,,,
1296,P509_color_image0.jpg,112,-4,74,78,,,,
1297,P510_color_image0.jpg,112,-3,74,77,,,,
1298,P515_color_image0.jpg,112,9,82,73,,,,
1299,P518_color_image0.jpg,112,-12,66,78,,,,
1300,P519_color_image0.jpg,112,4,74,70,,,,
1301,P521_color_image0.jpg,112,7,71,64,,,,
1302,P525_color_image0.jpg,112,-2,74,76,,,,
1303,P529_color_image0.jpg,112,3,71,68,,,,
1304,P551_color_image0.jpg,112,-1,74,75,,,,
1305,P556_color_image0.jpg,112,9,80,71,,,,
1306,P557_color_image0.jpg,112,7,78,71,,,,
1307,P564_color_image0.jpg,112,2,69,67,,,,
1308,P565_color_image0.jpg,112,8,71,63,,,,
1309,P572_color_image0.jpg,112,0,78,78,,,,
1310,P575_color_image0.jpg,112,13,71,58,,,,
1311,P576_color_image0.jpg,112,4,71,67,,,,
1312,P577_color_image0.jpg,112,-3,74,77,,,,
1313,P578_color_image0.jpg,112,8,77,69,,,,
1314,P582_color_image0.jpg,112,9,78,69,,,,
1315,P585_color_image0.jpg,112,-2,69,71,,,,
1316,P586_color_image0.jpg,112,1,79,78,,,,
1317,P592_color_image0.jpg,112,-5,64,69,,,,
1318,P594_color_image0.jpg,112,-3,75,78,,,,
1319,P596_color_image0.jpg,112,9,81,72,,,,
1320,P601_color_image0.jpg,112,-3,69,72,,,,
1321,P602_color_image0.jpg,112,3,72,69,,,,
1322,P605_color_image0.jpg,112,1,72,71,,,,
1323,P606_color_image0.jpg,112,-5,72,77,,,,
1324,P609_color_image0.jpg,112,3,74,71,,,,
1325,P612_color_image0.jpg,112,-3,72,75,,,,
1326,P617_color_image0.jpg,112,-2,72,74,,,,
1327,P618-1_color_image0.jpg,112,4,78,74,,,,
1328,P619_color_image0.jpg,112,-9,68,77,,,,
1329,P622_color_image0.jpg,112,4,79,75,,,,
1330,P632_color_image0.jpg,112,-8,71,79,,,,
1331,P635_color_image0.jpg,112,-6,71,77,,,,
1332,P636_color_image0.jpg,112,0,73,73,,,,
1333,P638_color_image0.jpg,112,1,74,73,,,,
1334,P645_color_image0.jpg,112,-12,64,76,,,,
1335,P651_color_image0.jpg,112,0,72,72,,,,
1336,P653_color_image0.jpg,112,-3,74,77,,,,
1337,P673_color_image0.jpg,112,-8,69,77,,,,
1338,P674_color_image0.jpg,112,-1,72,73,,,,
1339,P676_color_image0.jpg,112,14,78,64,,,,
1340,P677_color_image0.jpg,112,-8,70,78,,,,
1341,P680_color_image0.jpg,112,-4,65,69,,,,
1342,P681_color_image0.jpg,112,1,73,72,,,,
1343,P690_color_image0.jpg,112,8,71,63,,,,
1344,P694_color_image0.jpg,112,-9,68,77,,,,
1345,P703_color_image0.jpg,112,-1,65,66,,,,
1346,P704_color_image0.jpg,112,3,75,72,,,,
1347,P710_color_image0.jpg,112,6,76,70,,,,
1348,P712_color_image0.jpg,112,0,68,68,,,,
1349,P717_color_image0.jpg,112,3,74,71,,,,
1350,P724_color_image0.jpg,112,7,74,67,,,,
1351,P728_color_image0.jpg,112,-2,75,77,,,,
1352,P742-1_color_image0.jpg,112,7,76,69,,,,
1353,P744_color_image0.jpg,112,1,74,73,,,,
1354,P745-1_color_image0.jpg,112,-5,66,71,,,,
1355,P747_color_image0.jpg,112,8,73,65,,,,
1356,P759-1_color_image0.jpg,112,-6,72,78,,,,
1357,P766-1_color_image0.jpg,112,15,71,56,,,,
1358,P776-1_color_image0.jpg,112,12,80,68,,,,
1359,p172_color_image0.jpg,113,-7,66,73,-1.026490066,,,
1360,p175_color_image0.jpg,113,-9,68,77,,,,
1361,P188_color_image0.jpg,113,1,77,76,,,,
1362,p191_color_image0.jpg,113,1,71,70,,,,
1363,p196_color_image0.jpg,113,-9,62,71,,,,
1364,p197_color_image0.jpg,113,-1,76,77,,,,
1365,p198_color_image0.jpg,113,-3,69,72,,,,
1366,p200_color_image0.jpg,113,-3,74,77,,,,
1367,P210_color_image0.jpg,113,-1,77,78,,,,
1368,p211_color_image0.jpg,113,5,80,75,,,,
1369,P220_color_image0.jpg,113,10,80,70,,,,
1370,p222_color_image0.jpg,113,-1,68,69,,,,
1371,p223_color_image0.jpg,113,7,72,65,,,,
1372,p230_color_image0.jpg,113,14,72,58,,,,
1373,p232-2_color_image0.jpg,113,2,77,75,,,,
1374,p237-1_color_image0.jpg,113,0,73,73,,,,
1375,p240_color_image0.jpg,113,-13,66,79,,,,
1376,p249_color_image0.jpg,113,-5,71,76,,,,
1377,p250_color_image0.jpg,113,1,69,68,,,,
1378,p253_color_image0.jpg,113,-4,72,76,,,,
1379,p255_color_image0.jpg,113,-2,72,74,,,,
1380,p256_color_image0.jpg,113,-2,69,71,,,,
1381,p260_color_image0.jpg,113,-11,65,76,,,,
1382,p261_color_image0.jpg,113,0,72,72,,,,
1383,p263_color_image0.jpg,113,1,69,68,,,,
1384,P267_color_image0.jpg,113,4,72,68,,,,
1385,p272_color_image0.jpg,113,1,73,72,,,,
1386,p279_color_image0.jpg,113,9,72,63,,,,
1387,P280_color_image0.jpg,113,-2,70,72,,,,
1388,P282_color_image0.jpg,113,4,76,72,,,,
1389,p284_color_image0.jpg,113,-3,72,75,,,,
1390,p287_color_image0.jpg,113,0,71,71,,,,
1391,p288_color_image0.jpg,113,-9,69,78,,,,
1392,p289_color_image0.jpg,113,6,77,71,,,,
1393,p302_color_image0.jpg,113,0,72,72,,,,
1394,p306_color_image0.jpg,113,7,77,70,,,,
1395,p311_color_image0.jpg,113,-3,75,78,,,,
1396,P321_color_image0.jpg,113,-1,76,77,,,,
1397,p327_color_image0.jpg,113,-6,71,77,,,,
1398,p344_color_image0.jpg,113,-5,65,70,,,,
1399,p345_color_image0.jpg,113,1,68,67,,,,
1400,p346-1_color_image0.jpg,113,-5,63,68,,,,
1401,p347_color_image0.jpg,113,-2,71,73,,,,
1402,p351_color_image0.jpg,113,1,71,70,,,,
1403,P354_color_image0.jpg,113,-5,72,77,,,,
1404,p362_color_image0.jpg,113,6,81,75,,,,
1405,p366_color_image0.jpg,113,-1,77,78,,,,
1406,p368_color_image0.jpg,113,3,71,68,,,,
1407,p378_color_image0.jpg,113,-4,74,78,,,,
1408,p386_color_image0.jpg,113,-6,71,77,,,,
1409,P395_color_image0.jpg,113,-9,68,77,,,,
1410,p397_color_image0.jpg,113,0,72,72,,,,
1411,p398_color_image0.jpg,113,-7,69,76,,,,
1412,p399_color_image0.jpg,113,-5,66,71,,,,
1413,p403_color_image0.jpg,113,-6,69,75,,,,
1414,p412_color_image0.jpg,113,0,72,72,,,,
1415,p415_color_image0.jpg,113,2,72,70,,,,
1416,p422_color_image0.jpg,113,13,69,56,,,,
1417,p424_color_image0.jpg,113,7,76,69,,,,
1418,p425_color_image0.jpg,113,-4,71,75,,,,
1419,p430_color_image0.jpg,113,3,80,77,,,,
1420,p431_color_image0.jpg,113,-5,67,72,,,,
1421,p432_color_image0.jpg,113,-2,74,76,,,,
1422,p435_color_image0.jpg,113,-5,68,73,,,,
1423,p438_color_image0.jpg,113,-6,72,78,,,,
1424,P439_color_image0.jpg,113,12,82,70,,,,
1425,p440_color_image0.jpg,113,-5,72,77,,,,
1426,p441_color_image0.jpg,113,2,72,70,,,,
1427,p442_color_image0.jpg,113,0,71,71,,,,
1428,p445_color_image0.jpg,113,-4,71,75,,,,
1429,p452_color_image0.jpg,113,-4,74,78,,,,
1430,p454_color_image0.jpg,113,0,68,68,,,,
1431,p462_color_image0.jpg,113,-10,67,77,,,,
1432,P467_color_image0.jpg,113,-3,72,75,,,,
1433,p469_color_image0.jpg,113,-11,66,77,,,,
1434,P472_color_image0.jpg,113,2,78,76,,,,
1435,p474_color_image0.jpg,113,2,72,70,,,,
1436,p477_color_image0.jpg,113,2,78,76,,,,
1437,P481_color_image0.jpg,113,-4,71,75,,,,
1438,P482_color_image0.jpg,113,-1,71,72,,,,
1439,P484_color_image0.jpg,113,6,71,65,,,,
1440,P485_color_image0.jpg,113,10,74,64,,,,
1441,P491_color_image0.jpg,113,-11,66,77,,,,
1442,P495_color_image0.jpg,113,8,77,69,,,,
1443,P499_color_image0.jpg,113,7,70,63,,,,
1444,P501_color_image0.jpg,113,-8,63,71,,,,
1445,P505_color_image0.jpg,113,9,77,68,,,,
1446,P507_color_image0.jpg,113,-5,71,76,,,,
1447,P509_color_image0.jpg,113,-12,66,78,,,,
1448,P510_color_image0.jpg,113,-6,71,77,,,,
1449,P515_color_image0.jpg,113,-2,71,73,,,,
1450,P518_color_image0.jpg,113,-10,68,78,,,,
1451,P519_color_image0.jpg,113,2,72,70,,,,
1452,P521_color_image0.jpg,113,5,69,64,,,,
1453,P525_color_image0.jpg,113,-4,72,76,,,,
1454,P529_color_image0.jpg,113,-8,60,68,,,,
1455,P551_color_image0.jpg,113,-3,72,75,,,,
1456,P556_color_image0.jpg,113,1,72,71,,,,
1457,P557_color_image0.jpg,113,2,73,71,,,,
1458,P564_color_image0.jpg,113,2,69,67,,,,
1459,P565_color_image0.jpg,113,9,72,63,,,,
1460,P572_color_image0.jpg,113,2,80,78,,,,
1461,P575_color_image0.jpg,113,13,71,58,,,,
1462,P576_color_image0.jpg,113,3,70,67,,,,
1463,P577_color_image0.jpg,113,-5,72,77,,,,
1464,P578_color_image0.jpg,113,5,74,69,,,,
1465,P582_color_image0.jpg,113,3,72,69,,,,
1466,P585_color_image0.jpg,113,1,72,71,,,,
1467,P586_color_image0.jpg,113,-6,72,78,,,,
1468,P592_color_image0.jpg,113,-4,65,69,,,,
1469,P594_color_image0.jpg,113,-10,68,78,,,,
1470,P596_color_image0.jpg,113,1,73,72,,,,
1471,P601_color_image0.jpg,113,-10,62,72,,,,
1472,P602_color_image0.jpg,113,0,69,69,,,,
1473,P605_color_image0.jpg,113,-2,69,71,,,,
1474,P606_color_image0.jpg,113,-3,74,77,,,,
1475,P609_color_image0.jpg,113,4,75,71,,,,
1476,P612_color_image0.jpg,113,-3,72,75,,,,
1477,P617_color_image0.jpg,113,-1,73,74,,,,
1478,P618-1_color_image0.jpg,113,6,80,74,,,,
1479,P619_color_image0.jpg,113,-9,68,77,,,,
1480,P622_color_image0.jpg,113,2,77,75,,,,
1481,P632_color_image0.jpg,113,-7,72,79,,,,
1482,P635_color_image0.jpg,113,-13,64,77,,,,
1483,P636_color_image0.jpg,113,-2,71,73,,,,
1484,P638_color_image0.jpg,113,-2,71,73,,,,
1485,P645_color_image0.jpg,113,-6,70,76,,,,
1486,P651_color_image0.jpg,113,-3,69,72,,,,
1487,P653_color_image0.jpg,113,1,78,77,,,,
1488,P673_color_image0.jpg,113,-9,68,77,,,,
1489,P674_color_image0.jpg,113,0,73,73,,,,
1490,P676_color_image0.jpg,113,7,71,64,,,,
1491,P677_color_image0.jpg,113,-9,69,78,,,,
1492,P680_color_image0.jpg,113,-3,66,69,,,,
1493,P681_color_image0.jpg,113,2,74,72,,,,
1494,P690_color_image0.jpg,113,-2,61,63,,,,
1495,P694_color_image0.jpg,113,-11,66,77,,,,
1496,P703_color_image0.jpg,113,-1,65,66,,,,
1497,P704_color_image0.jpg,113,3,75,72,,,,
1498,P710_color_image0.jpg,113,2,72,70,,,,
1499,P712_color_image0.jpg,113,-3,65,68,,,,
1500,P717_color_image0.jpg,113,1,72,71,,,,
1501,P724_color_image0.jpg,113,-1,66,67,,,,
1502,P728_color_image0.jpg,113,-5,72,77,,,,
1503,P742-1_color_image0.jpg,113,2,71,69,,,,
1504,P744_color_image0.jpg,113,-1,72,73,,,,
1505,P745-1_color_image0.jpg,113,-2,69,71,,,,
1506,P747_color_image0.jpg,113,6,71,65,,,,
1507,P759-1_color_image0.jpg,113,-6,72,78,,,,
1508,P766-1_color_image0.jpg,113,12,68,56,,,,
1509,P776-1_color_image0.jpg,113,1,69,68,,,,
1510,p172_color_image0.jpg,114,-8,65,73,-0.668874172,,,
1511,p175_color_image0.jpg,114,-12,65,77,,,,
1512,P188_color_image0.jpg,114,-5,71,76,,,,
1513,p191_color_image0.jpg,114,2,72,70,,,,
1514,p196_color_image0.jpg,114,-5,66,71,,,,
1515,p197_color_image0.jpg,114,3,80,77,,,,
1516,p198_color_image0.jpg,114,-1,71,72,,,,
1517,p200_color_image0.jpg,114,-4,73,77,,,,
1518,P210_color_image0.jpg,114,-1,77,78,,,,
1519,p211_color_image0.jpg,114,3,78,75,,,,
1520,P220_color_image0.jpg,114,4,74,70,,,,
1521,p222_color_image0.jpg,114,11,80,69,,,,
1522,p223_color_image0.jpg,114,-5,60,65,,,,
1523,p230_color_image0.jpg,114,16,74,58,,,,
1524,p232-2_color_image0.jpg,114,0,75,75,,,,
1525,p237-1_color_image0.jpg,114,-1,72,73,,,,
1526,p240_color_image0.jpg,114,-8,71,79,,,,
1527,p249_color_image0.jpg,114,-5,71,76,,,,
1528,p250_color_image0.jpg,114,0,68,68,,,,
1529,p253_color_image0.jpg,114,-5,71,76,,,,
1530,p255_color_image0.jpg,114,-3,71,74,,,,
1531,p256_color_image0.jpg,114,-2,69,71,,,,
1532,p260_color_image0.jpg,114,-3,73,76,,,,
1533,p261_color_image0.jpg,114,-1,71,72,,,,
1534,p263_color_image0.jpg,114,0,68,68,,,,
1535,P267_color_image0.jpg,114,5,73,68,,,,
1536,p272_color_image0.jpg,114,-1,71,72,,,,
1537,p279_color_image0.jpg,114,8,71,63,,,,
1538,P280_color_image0.jpg,114,-7,65,72,,,,
1539,P282_color_image0.jpg,114,2,74,72,,,,
1540,p284_color_image0.jpg,114,-4,71,75,,,,
1541,p287_color_image0.jpg,114,0,71,71,,,,
1542,p288_color_image0.jpg,114,-10,68,78,,,,
1543,p289_color_image0.jpg,114,1,72,71,,,,
1544,p302_color_image0.jpg,114,0,72,72,,,,
1545,p306_color_image0.jpg,114,2,72,70,,,,
1546,p311_color_image0.jpg,114,-4,74,78,,,,
1547,P321_color_image0.jpg,114,-2,75,77,,,,
1548,p327_color_image0.jpg,114,-6,71,77,,,,
1549,p344_color_image0.jpg,114,7,77,70,,,,
1550,p345_color_image0.jpg,114,2,69,67,,,,
1551,p346-1_color_image0.jpg,114,-4,64,68,,,,
1552,p347_color_image0.jpg,114,-4,69,73,,,,
1553,p351_color_image0.jpg,114,1,71,70,,,,
1554,P354_color_image0.jpg,114,-12,65,77,,,,
1555,p362_color_image0.jpg,114,-6,69,75,,,,
1556,p366_color_image0.jpg,114,-6,72,78,,,,
1557,p368_color_image0.jpg,114,4,72,68,,,,
1558,p378_color_image0.jpg,114,-5,73,78,,,,
1559,p386_color_image0.jpg,114,-7,70,77,,,,
1560,P395_color_image0.jpg,114,-5,72,77,,,,
1561,p397_color_image0.jpg,114,0,72,72,,,,
1562,p398_color_image0.jpg,114,-5,71,76,,,,
1563,p399_color_image0.jpg,114,0,71,71,,,,
1564,p403_color_image0.jpg,114,-3,72,75,,,,
1565,p412_color_image0.jpg,114,-4,68,72,,,,
1566,p415_color_image0.jpg,114,4,74,70,,,,
1567,p422_color_image0.jpg,114,13,69,56,,,,
1568,p424_color_image0.jpg,114,9,78,69,,,,
1569,p425_color_image0.jpg,114,-4,71,75,,,,
1570,p430_color_image0.jpg,114,-3,74,77,,,,
1571,p431_color_image0.jpg,114,-4,68,72,,,,
1572,p432_color_image0.jpg,114,-2,74,76,,,,
1573,p435_color_image0.jpg,114,-1,72,73,,,,
1574,p438_color_image0.jpg,114,-6,72,78,,,,
1575,P439_color_image0.jpg,114,4,74,70,,,,
1576,p440_color_image0.jpg,114,-4,73,77,,,,
1577,p441_color_image0.jpg,114,4,74,70,,,,
1578,p442_color_image0.jpg,114,-1,70,71,,,,
1579,p445_color_image0.jpg,114,-4,71,75,,,,
1580,p452_color_image0.jpg,114,-4,74,78,,,,
1581,p454_color_image0.jpg,114,1,69,68,,,,
1582,p462_color_image0.jpg,114,-9,68,77,,,,
1583,P467_color_image0.jpg,114,-3,72,75,,,,
1584,p469_color_image0.jpg,114,-6,71,77,,,,
1585,P472_color_image0.jpg,114,-1,75,76,,,,
1586,p474_color_image0.jpg,114,1,71,70,,,,
1587,p477_color_image0.jpg,114,-2,74,76,,,,
1588,P481_color_image0.jpg,114,-1,74,75,,,,
1589,P482_color_image0.jpg,114,-3,69,72,,,,
1590,P484_color_image0.jpg,114,4,69,65,,,,
1591,P485_color_image0.jpg,114,8,72,64,,,,
1592,P491_color_image0.jpg,114,-18,59,77,,,,
1593,P495_color_image0.jpg,114,6,75,69,,,,
1594,P499_color_image0.jpg,114,3,66,63,,,,
1595,P501_color_image0.jpg,114,-6,65,71,,,,
1596,P505_color_image0.jpg,114,5,73,68,,,,
1597,P507_color_image0.jpg,114,-5,71,76,,,,
1598,P509_color_image0.jpg,114,-3,75,78,,,,
1599,P510_color_image0.jpg,114,-2,75,77,,,,
1600,P515_color_image0.jpg,114,7,80,73,,,,
1601,P518_color_image0.jpg,114,-7,71,78,,,,
1602,P519_color_image0.jpg,114,4,74,70,,,,
1603,P521_color_image0.jpg,114,7,71,64,,,,
1604,P525_color_image0.jpg,114,-4,72,76,,,,
1605,P529_color_image0.jpg,114,4,72,68,,,,
1606,P551_color_image0.jpg,114,2,77,75,,,,
1607,P556_color_image0.jpg,114,4,75,71,,,,
1608,P557_color_image0.jpg,114,6,77,71,,,,
1609,P564_color_image0.jpg,114,0,67,67,,,,
1610,P565_color_image0.jpg,114,8,71,63,,,,
1611,P572_color_image0.jpg,114,-2,76,78,,,,
1612,P575_color_image0.jpg,114,8,66,58,,,,
1613,P576_color_image0.jpg,114,2,69,67,,,,
1614,P577_color_image0.jpg,114,-3,74,77,,,,
1615,P578_color_image0.jpg,114,8,77,69,,,,
1616,P582_color_image0.jpg,114,7,76,69,,,,
1617,P585_color_image0.jpg,114,1,72,71,,,,
1618,P586_color_image0.jpg,114,-7,71,78,,,,
1619,P592_color_image0.jpg,114,-4,65,69,,,,
1620,P594_color_image0.jpg,114,-8,70,78,,,,
1621,P596_color_image0.jpg,114,9,81,72,,,,
1622,P601_color_image0.jpg,114,-10,62,72,,,,
1623,P602_color_image0.jpg,114,2,71,69,,,,
1624,P605_color_image0.jpg,114,1,72,71,,,,
1625,P606_color_image0.jpg,114,-4,73,77,,,,
1626,P609_color_image0.jpg,114,2,73,71,,,,
1627,P612_color_image0.jpg,114,-2,73,75,,,,
1628,P617_color_image0.jpg,114,0,74,74,,,,
1629,P618-1_color_image0.jpg,114,3,77,74,,,,
1630,P619_color_image0.jpg,114,0,77,77,,,,
1631,P622_color_image0.jpg,114,4,79,75,,,,
1632,P632_color_image0.jpg,114,-8,71,79,,,,
1633,P635_color_image0.jpg,114,-6,71,77,,,,
1634,P636_color_image0.jpg,114,-5,68,73,,,,
1635,P638_color_image0.jpg,114,-1,72,73,,,,
1636,P645_color_image0.jpg,114,-4,72,76,,,,
1637,P651_color_image0.jpg,114,0,72,72,,,,
1638,P653_color_image0.jpg,114,-14,63,77,,,,
1639,P673_color_image0.jpg,114,-9,68,77,,,,
1640,P674_color_image0.jpg,114,1,74,73,,,,
1641,P676_color_image0.jpg,114,9,73,64,,,,
1642,P677_color_image0.jpg,114,-7,71,78,,,,
1643,P680_color_image0.jpg,114,-1,68,69,,,,
1644,P681_color_image0.jpg,114,1,73,72,,,,
1645,P690_color_image0.jpg,114,3,66,63,,,,
1646,P694_color_image0.jpg,114,-5,72,77,,,,
1647,P703_color_image0.jpg,114,3,69,66,,,,
1648,P704_color_image0.jpg,114,2,74,72,,,,
1649,P710_color_image0.jpg,114,2,72,70,,,,
1650,P712_color_image0.jpg,114,1,69,68,,,,
1651,P717_color_image0.jpg,114,3,74,71,,,,
1652,P724_color_image0.jpg,114,8,75,67,,,,
1653,P728_color_image0.jpg,114,-5,72,77,,,,
1654,P742-1_color_image0.jpg,114,6,75,69,,,,
1655,P744_color_image0.jpg,114,-2,71,73,,,,
1656,P745-1_color_image0.jpg,114,-2,69,71,,,,
1657,P747_color_image0.jpg,114,0,65,65,,,,
1658,P759-1_color_image0.jpg,114,-6,72,78,,,,
1659,P766-1_color_image0.jpg,114,13,69,56,,,,
1660,P776-1_color_image0.jpg,114,7,75,68,,,,
1661,p172_color_image0.jpg,115,-7,66,73,-1.01986755,,,
1662,p175_color_image0.jpg,115,-6,71,77,,,,
1663,P188_color_image0.jpg,115,3,79,76,,,,
1664,p191_color_image0.jpg,115,1,71,70,,,,
1665,p196_color_image0.jpg,115,-8,63,71,,,,
1666,p197_color_image0.jpg,115,-2,75,77,,,,
1667,p198_color_image0.jpg,115,-1,71,72,,,,
1668,p200_color_image0.jpg,115,-11,66,77,,,,
1669,P210_color_image0.jpg,115,0,78,78,,,,
1670,p211_color_image0.jpg,115,3,78,75,,,,
1671,P220_color_image0.jpg,115,4,74,70,,,,
1672,p222_color_image0.jpg,115,5,74,69,,,,
1673,p223_color_image0.jpg,115,-2,63,65,,,,
1674,p230_color_image0.jpg,115,16,74,58,,,,
1675,p232-2_color_image0.jpg,115,-4,71,75,,,,
1676,p237-1_color_image0.jpg,115,-2,71,73,,,,
1677,p240_color_image0.jpg,115,-11,68,79,,,,
1678,p249_color_image0.jpg,115,-5,71,76,,,,
1679,p250_color_image0.jpg,115,0,68,68,,,,
1680,p253_color_image0.jpg,115,-5,71,76,,,,
1681,p255_color_image0.jpg,115,-5,69,74,,,,
1682,p256_color_image0.jpg,115,-5,66,71,,,,
1683,p260_color_image0.jpg,115,3,79,76,,,,
1684,p261_color_image0.jpg,115,-1,71,72,,,,
1685,p263_color_image0.jpg,115,0,68,68,,,,
1686,P267_color_image0.jpg,115,5,73,68,,,,
1687,p272_color_image0.jpg,115,-5,67,72,,,,
1688,p279_color_image0.jpg,115,8,71,63,,,,
1689,P280_color_image0.jpg,115,-6,66,72,,,,
1690,P282_color_image0.jpg,115,-2,70,72,,,,
1691,p284_color_image0.jpg,115,-3,72,75,,,,
1692,p287_color_image0.jpg,115,1,72,71,,,,
1693,p288_color_image0.jpg,115,-10,68,78,,,,
1694,p289_color_image0.jpg,115,3,74,71,,,,
1695,p302_color_image0.jpg,115,-3,69,72,,,,
1696,p306_color_image0.jpg,115,1,71,70,,,,
1697,p311_color_image0.jpg,115,-6,72,78,,,,
1698,P321_color_image0.jpg,115,-2,75,77,,,,
1699,p327_color_image0.jpg,115,-8,69,77,,,,
1700,p344_color_image0.jpg,115,2,72,70,,,,
1701,p345_color_image0.jpg,115,3,70,67,,,,
1702,p346-1_color_image0.jpg,115,-3,65,68,,,,
1703,p347_color_image0.jpg,115,-3,70,73,,,,
1704,p351_color_image0.jpg,115,1,71,70,,,,
1705,P354_color_image0.jpg,115,-7,70,77,,,,
1706,p362_color_image0.jpg,115,-6,69,75,,,,
1707,p366_color_image0.jpg,115,-6,72,78,,,,
1708,p368_color_image0.jpg,115,1,69,68,,,,
1709,p378_color_image0.jpg,115,-6,72,78,,,,
1710,p386_color_image0.jpg,115,-6,71,77,,,,
1711,P395_color_image0.jpg,115,-5,72,77,,,,
1712,p397_color_image0.jpg,115,-1,71,72,,,,
1713,p398_color_image0.jpg,115,-5,71,76,,,,
1714,p399_color_image0.jpg,115,-4,67,71,,,,
1715,p403_color_image0.jpg,115,-4,71,75,,,,
1716,p412_color_image0.jpg,115,-5,67,72,,,,
1717,p415_color_image0.jpg,115,2,72,70,,,,
1718,p422_color_image0.jpg,115,9,65,56,,,,
1719,p424_color_image0.jpg,115,6,75,69,,,,
1720,p425_color_image0.jpg,115,-2,73,75,,,,
1721,p430_color_image0.jpg,115,-3,74,77,,,,
1722,p431_color_image0.jpg,115,-3,69,72,,,,
1723,p432_color_image0.jpg,115,-1,75,76,,,,
1724,p435_color_image0.jpg,115,1,74,73,,,,
1725,p438_color_image0.jpg,115,-5,73,78,,,,
1726,P439_color_image0.jpg,115,2,72,70,,,,
1727,p440_color_image0.jpg,115,-5,72,77,,,,
1728,p441_color_image0.jpg,115,1,71,70,,,,
1729,p442_color_image0.jpg,115,1,72,71,,,,
1730,p445_color_image0.jpg,115,-10,65,75,,,,
1731,p452_color_image0.jpg,115,-6,72,78,,,,
1732,p454_color_image0.jpg,115,3,71,68,,,,
1733,p462_color_image0.jpg,115,-10,67,77,,,,
1734,P467_color_image0.jpg,115,-3,72,75,,,,
1735,p469_color_image0.jpg,115,-2,75,77,,,,
1736,P472_color_image0.jpg,115,1,77,76,,,,
1737,p474_color_image0.jpg,115,-4,66,70,,,,
1738,p477_color_image0.jpg,115,-4,72,76,,,,
1739,P481_color_image0.jpg,115,-3,72,75,,,,
1740,P482_color_image0.jpg,115,-4,68,72,,,,
1741,P484_color_image0.jpg,115,7,72,65,,,,
1742,P485_color_image0.jpg,115,7,71,64,,,,
1743,P491_color_image0.jpg,115,-14,63,77,,,,
1744,P495_color_image0.jpg,115,5,74,69,,,,
1745,P499_color_image0.jpg,115,4,67,63,,,,
1746,P501_color_image0.jpg,115,-5,66,71,,,,
1747,P505_color_image0.jpg,115,3,71,68,,,,
1748,P507_color_image0.jpg,115,-5,71,76,,,,
1749,P509_color_image0.jpg,115,-9,69,78,,,,
1750,P510_color_image0.jpg,115,-5,72,77,,,,
1751,P515_color_image0.jpg,115,11,84,73,,,,
1752,P518_color_image0.jpg,115,-9,69,78,,,,
1753,P519_color_image0.jpg,115,5,75,70,,,,
1754,P521_color_image0.jpg,115,7,71,64,,,,
1755,P525_color_image0.jpg,115,-5,71,76,,,,
1756,P529_color_image0.jpg,115,3,71,68,,,,
1757,P551_color_image0.jpg,115,-1,74,75,,,,
1758,P556_color_image0.jpg,115,4,75,71,,,,
1759,P557_color_image0.jpg,115,6,77,71,,,,
1760,P564_color_image0.jpg,115,1,68,67,,,,
1761,P565_color_image0.jpg,115,9,72,63,,,,
1762,P572_color_image0.jpg,115,1,79,78,,,,
1763,P575_color_image0.jpg,115,6,64,58,,,,
1764,P576_color_image0.jpg,115,4,71,67,,,,
1765,P577_color_image0.jpg,115,-4,73,77,,,,
1766,P578_color_image0.jpg,115,2,71,69,,,,
1767,P582_color_image0.jpg,115,3,72,69,,,,
1768,P585_color_image0.jpg,115,-2,69,71,,,,
1769,P586_color_image0.jpg,115,-4,74,78,,,,
1770,P592_color_image0.jpg,115,-4,65,69,,,,
1771,P594_color_image0.jpg,115,-9,69,78,,,,
1772,P596_color_image0.jpg,115,14,86,72,,,,
1773,P601_color_image0.jpg,115,-8,64,72,,,,
1774,P602_color_image0.jpg,115,3,72,69,,,,
1775,P605_color_image0.jpg,115,0,71,71,,,,
1776,P606_color_image0.jpg,115,-4,73,77,,,,
1777,P609_color_image0.jpg,115,4,75,71,,,,
1778,P612_color_image0.jpg,115,-3,72,75,,,,
1779,P617_color_image0.jpg,115,1,75,74,,,,
1780,P618-1_color_image0.jpg,115,2,76,74,,,,
1781,P619_color_image0.jpg,115,-3,74,77,,,,
1782,P622_color_image0.jpg,115,3,78,75,,,,
1783,P632_color_image0.jpg,115,-7,72,79,,,,
1784,P635_color_image0.jpg,115,-6,71,77,,,,
1785,P636_color_image0.jpg,115,-1,72,73,,,,
1786,P638_color_image0.jpg,115,1,74,73,,,,
1787,P645_color_image0.jpg,115,-6,70,76,,,,
1788,P651_color_image0.jpg,115,-1,71,72,,,,
1789,P653_color_image0.jpg,115,-12,65,77,,,,
1790,P673_color_image0.jpg,115,-11,66,77,,,,
1791,P674_color_image0.jpg,115,-4,69,73,,,,
1792,P676_color_image0.jpg,115,14,78,64,,,,
1793,P677_color_image0.jpg,115,-7,71,78,,,,
1794,P680_color_image0.jpg,115,0,69,69,,,,
1795,P681_color_image0.jpg,115,5,77,72,,,,
1796,P690_color_image0.jpg,115,11,74,63,,,,
1797,P694_color_image0.jpg,115,-11,66,77,,,,
1798,P703_color_image0.jpg,115,0,66,66,,,,
1799,P704_color_image0.jpg,115,-4,68,72,,,,
1800,P710_color_image0.jpg,115,4,74,70,,,,
1801,P712_color_image0.jpg,115,-4,64,68,,,,
1802,P717_color_image0.jpg,115,2,73,71,,,,
1803,P724_color_image0.jpg,115,6,73,67,,,,
1804,P728_color_image0.jpg,115,-1,76,77,,,,
1805,P742-1_color_image0.jpg,115,9,78,69,,,,
1806,P744_color_image0.jpg,115,-10,63,73,,,,
1807,P745-1_color_image0.jpg,115,-1,70,71,,,,
1808,P747_color_image0.jpg,115,8,73,65,,,,
1809,P759-1_color_image0.jpg,115,-7,71,78,,,,
1810,P766-1_color_image0.jpg,115,14,70,56,,,,
1811,P776-1_color_image0.jpg,115,4,72,68,,,,
1812,p172_color_image0.jpg,116,-7,66,73,0.523178808,,,
1813,p175_color_image0.jpg,116,-1,76,77,,,,
1814,P188_color_image0.jpg,116,3,79,76,,,,
1815,p191_color_image0.jpg,116,2,72,70,,,,
1816,p196_color_image0.jpg,116,-4,67,71,,,,
1817,p197_color_image0.jpg,116,1,78,77,,,,
1818,p198_color_image0.jpg,116,-10,62,72,,,,
1819,p200_color_image0.jpg,116,-2,75,77,,,,
1820,P210_color_image0.jpg,116,-1,77,78,,,,
1821,p211_color_image0.jpg,116,4,79,75,,,,
1822,P220_color_image0.jpg,116,4,74,70,,,,
1823,p222_color_image0.jpg,116,5,74,69,,,,
1824,p223_color_image0.jpg,116,6,71,65,,,,
1825,p230_color_image0.jpg,116,16,74,58,,,,
1826,p232-2_color_image0.jpg,116,-1,74,75,,,,
1827,p237-1_color_image0.jpg,116,1,74,73,,,,
1828,p240_color_image0.jpg,116,-11,68,79,,,,
1829,p249_color_image0.jpg,116,-5,71,76,,,,
1830,p250_color_image0.jpg,116,1,69,68,,,,
1831,p253_color_image0.jpg,116,-5,71,76,,,,
1832,p255_color_image0.jpg,116,-2,72,74,,,,
1833,p256_color_image0.jpg,116,0,71,71,,,,
1834,p260_color_image0.jpg,116,-2,74,76,,,,
1835,p261_color_image0.jpg,116,-2,70,72,,,,
1836,p263_color_image0.jpg,116,4,72,68,,,,
1837,P267_color_image0.jpg,116,7,75,68,,,,
1838,p272_color_image0.jpg,116,3,75,72,,,,
1839,p279_color_image0.jpg,116,9,72,63,,,,
1840,P280_color_image0.jpg,116,-1,71,72,,,,
1841,P282_color_image0.jpg,116,8,80,72,,,,
1842,p284_color_image0.jpg,116,-4,71,75,,,,
1843,p287_color_image0.jpg,116,0,71,71,,,,
1844,p288_color_image0.jpg,116,-9,69,78,,,,
1845,p289_color_image0.jpg,116,9,80,71,,,,
1846,p302_color_image0.jpg,116,3,75,72,,,,
1847,p306_color_image0.jpg,116,5,75,70,,,,
1848,p311_color_image0.jpg,116,-4,74,78,,,,
1849,P321_color_image0.jpg,116,-2,75,77,,,,
1850,p327_color_image0.jpg,116,-6,71,77,,,,
1851,p344_color_image0.jpg,116,1,71,70,,,,
1852,p345_color_image0.jpg,116,4,71,67,,,,
1853,p346-1_color_image0.jpg,116,-2,66,68,,,,
1854,p347_color_image0.jpg,116,-1,72,73,,,,
1855,p351_color_image0.jpg,116,1,71,70,,,,
1856,P354_color_image0.jpg,116,-5,72,77,,,,
1857,p362_color_image0.jpg,116,-5,70,75,,,,
1858,p366_color_image0.jpg,116,-4,74,78,,,,
1859,p368_color_image0.jpg,116,4,72,68,,,,
1860,p378_color_image0.jpg,116,-6,72,78,,,,
1861,p386_color_image0.jpg,116,-7,70,77,,,,
1862,P395_color_image0.jpg,116,-5,72,77,,,,
1863,p397_color_image0.jpg,116,0,72,72,,,,
1864,p398_color_image0.jpg,116,-5,71,76,,,,
1865,p399_color_image0.jpg,116,-5,66,71,,,,
1866,p403_color_image0.jpg,116,-3,72,75,,,,
1867,p412_color_image0.jpg,116,2,74,72,,,,
1868,p415_color_image0.jpg,116,3,73,70,,,,
1869,p422_color_image0.jpg,116,14,70,56,,,,
1870,p424_color_image0.jpg,116,10,79,69,,,,
1871,p425_color_image0.jpg,116,-4,71,75,,,,
1872,p430_color_image0.jpg,116,0,77,77,,,,
1873,p431_color_image0.jpg,116,-4,68,72,,,,
1874,p432_color_image0.jpg,116,-1,75,76,,,,
1875,p435_color_image0.jpg,116,-3,70,73,,,,
1876,p438_color_image0.jpg,116,-4,74,78,,,,
1877,P439_color_image0.jpg,116,2,72,70,,,,
1878,p440_color_image0.jpg,116,-3,74,77,,,,
1879,p441_color_image0.jpg,116,2,72,70,,,,
1880,p442_color_image0.jpg,116,4,75,71,,,,
1881,p445_color_image0.jpg,116,-5,70,75,,,,
1882,p452_color_image0.jpg,116,4,82,78,,,,
1883,p454_color_image0.jpg,116,-2,66,68,,,,
1884,p462_color_image0.jpg,116,-8,69,77,,,,
1885,P467_color_image0.jpg,116,-6,69,75,,,,
1886,p469_color_image0.jpg,116,-6,71,77,,,,
1887,P472_color_image0.jpg,116,-1,75,76,,,,
1888,p474_color_image0.jpg,116,2,72,70,,,,
1889,p477_color_image0.jpg,116,5,81,76,,,,
1890,P481_color_image0.jpg,116,2,77,75,,,,
1891,P482_color_image0.jpg,116,-1,71,72,,,,
1892,P484_color_image0.jpg,116,7,72,65,,,,
1893,P485_color_image0.jpg,116,10,74,64,,,,
1894,P491_color_image0.jpg,116,-5,72,77,,,,
1895,P495_color_image0.jpg,116,10,79,69,,,,
1896,P499_color_image0.jpg,116,8,71,63,,,,
1897,P501_color_image0.jpg,116,-5,66,71,,,,
1898,P505_color_image0.jpg,116,5,73,68,,,,
1899,P507_color_image0.jpg,116,-5,71,76,,,,
1900,P509_color_image0.jpg,116,-6,72,78,,,,
1901,P510_color_image0.jpg,116,-2,75,77,,,,
1902,P515_color_image0.jpg,116,7,80,73,,,,
1903,P518_color_image0.jpg,116,-7,71,78,,,,
1904,P519_color_image0.jpg,116,9,79,70,,,,
1905,P521_color_image0.jpg,116,8,72,64,,,,
1906,P525_color_image0.jpg,116,-4,72,76,,,,
1907,P529_color_image0.jpg,116,4,72,68,,,,
1908,P551_color_image0.jpg,116,3,78,75,,,,
1909,P556_color_image0.jpg,116,9,80,71,,,,
1910,P557_color_image0.jpg,116,4,75,71,,,,
1911,P564_color_image0.jpg,116,0,67,67,,,,
1912,P565_color_image0.jpg,116,9,72,63,,,,
1913,P572_color_image0.jpg,116,0,78,78,,,,
1914,P575_color_image0.jpg,116,11,69,58,,,,
1915,P576_color_image0.jpg,116,5,72,67,,,,
1916,P577_color_image0.jpg,116,-3,74,77,,,,
1917,P578_color_image0.jpg,116,8,77,69,,,,
1918,P582_color_image0.jpg,116,4,73,69,,,,
1919,P585_color_image0.jpg,116,3,74,71,,,,
1920,P586_color_image0.jpg,116,-6,72,78,,,,
1921,P592_color_image0.jpg,116,2,71,69,,,,
1922,P594_color_image0.jpg,116,-13,65,78,,,,
1923,P596_color_image0.jpg,116,3,75,72,,,,
1924,P601_color_image0.jpg,116,0,72,72,,,,
1925,P602_color_image0.jpg,116,3,72,69,,,,
1926,P605_color_image0.jpg,116,1,72,71,,,,
1927,P606_color_image0.jpg,116,-5,72,77,,,,
1928,P609_color_image0.jpg,116,3,74,71,,,,
1929,P612_color_image0.jpg,116,-3,72,75,,,,
1930,P617_color_image0.jpg,116,5,79,74,,,,
1931,P618-1_color_image0.jpg,116,3,77,74,,,,
1932,P619_color_image0.jpg,116,-1,76,77,,,,
1933,P622_color_image0.jpg,116,4,79,75,,,,
1934,P632_color_image0.jpg,116,-2,77,79,,,,
1935,P635_color_image0.jpg,116,-7,70,77,,,,
1936,P636_color_image0.jpg,116,1,74,73,,,,
1937,P638_color_image0.jpg,116,2,75,73,,,,
1938,P645_color_image0.jpg,116,-8,68,76,,,,
1939,P651_color_image0.jpg,116,0,72,72,,,,
1940,P653_color_image0.jpg,116,-6,71,77,,,,
1941,P673_color_image0.jpg,116,-7,70,77,,,,
1942,P674_color_image0.jpg,116,-4,69,73,,,,
1943,P676_color_image0.jpg,116,10,74,64,,,,
1944,P677_color_image0.jpg,116,-12,66,78,,,,
1945,P680_color_image0.jpg,116,-1,68,69,,,,
1946,P681_color_image0.jpg,116,2,74,72,,,,
1947,P690_color_image0.jpg,116,12,75,63,,,,
1948,P694_color_image0.jpg,116,-9,68,77,,,,
1949,P703_color_image0.jpg,116,2,68,66,,,,
1950,P704_color_image0.jpg,116,7,79,72,,,,
1951,P710_color_image0.jpg,116,5,75,70,,,,
1952,P712_color_image0.jpg,116,-5,63,68,,,,
1953,P717_color_image0.jpg,116,5,76,71,,,,
1954,P724_color_image0.jpg,116,4,71,67,,,,
1955,P728_color_image0.jpg,116,1,78,77,,,,
1956,P742-1_color_image0.jpg,116,9,78,69,,,,
1957,P744_color_image0.jpg,116,-2,71,73,,,,
1958,P745-1_color_image0.jpg,116,-2,69,71,,,,
1959,P747_color_image0.jpg,116,12,77,65,,,,
1960,P759-1_color_image0.jpg,116,-3,75,78,,,,
1961,P766-1_color_image0.jpg,116,10,66,56,,,,
1962,P776-1_color_image0.jpg,116,6,74,68,,,,
1963,p172_color_image0.jpg,117,-8,65,73,-1.006622517,,,
1964,p175_color_image0.jpg,117,-6,71,77,,,,
1965,P188_color_image0.jpg,117,1,77,76,,,,
1966,p191_color_image0.jpg,117,2,72,70,,,,
1967,p196_color_image0.jpg,117,-7,64,71,,,,
1968,p197_color_image0.jpg,117,-1,76,77,,,,
1969,p198_color_image0.jpg,117,-7,65,72,,,,
1970,p200_color_image0.jpg,117,-5,72,77,,,,
1971,P210_color_image0.jpg,117,-4,74,78,,,,
1972,p211_color_image0.jpg,117,4,79,75,,,,
1973,P220_color_image0.jpg,117,4,74,70,,,,
1974,p222_color_image0.jpg,117,3,72,69,,,,
1975,p223_color_image0.jpg,117,0,65,65,,,,
1976,p230_color_image0.jpg,117,14,72,58,,,,
1977,p232-2_color_image0.jpg,117,-1,74,75,,,,
1978,p237-1_color_image0.jpg,117,0,73,73,,,,
1979,p240_color_image0.jpg,117,-14,65,79,,,,
1980,p249_color_image0.jpg,117,-5,71,76,,,,
1981,p250_color_image0.jpg,117,-1,67,68,,,,
1982,p253_color_image0.jpg,117,-5,71,76,,,,
1983,p255_color_image0.jpg,117,-3,71,74,,,,
1984,p256_color_image0.jpg,117,1,72,71,,,,
1985,p260_color_image0.jpg,117,3,79,76,,,,
1986,p261_color_image0.jpg,117,-1,71,72,,,,
1987,p263_color_image0.jpg,117,0,68,68,,,,
1988,P267_color_image0.jpg,117,3,71,68,,,,
1989,p272_color_image0.jpg,117,-1,71,72,,,,
1990,p279_color_image0.jpg,117,9,72,63,,,,
1991,P280_color_image0.jpg,117,-3,69,72,,,,
1992,P282_color_image0.jpg,117,3,75,72,,,,
1993,p284_color_image0.jpg,117,-4,71,75,,,,
1994,p287_color_image0.jpg,117,0,71,71,,,,
1995,p288_color_image0.jpg,117,-11,67,78,,,,
1996,p289_color_image0.jpg,117,11,82,71,,,,
1997,p302_color_image0.jpg,117,-3,69,72,,,,
1998,p306_color_image0.jpg,117,2,72,70,,,,
1999,p311_color_image0.jpg,117,5,83,78,,,,
2000,P321_color_image0.jpg,117,-2,75,77,,,,
2001,p327_color_image0.jpg,117,-6,71,77,,,,
2002,p344_color_image0.jpg,117,-1,69,70,,,,
2003,p345_color_image0.jpg,117,2,69,67,,,,
2004,p346-1_color_image0.jpg,117,-7,61,68,,,,
2005,p347_color_image0.jpg,117,1,74,73,,,,
2006,p351_color_image0.jpg,117,1,71,70,,,,
2007,P354_color_image0.jpg,117,-9,68,77,,,,
2008,p362_color_image0.jpg,117,-9,66,75,,,,
2009,p366_color_image0.jpg,117,-5,73,78,,,,
2010,p368_color_image0.jpg,117,3,71,68,,,,
2011,p378_color_image0.jpg,117,-5,73,78,,,,
2012,p386_color_image0.jpg,117,-6,71,77,,,,
2013,P395_color_image0.jpg,117,-8,69,77,,,,
2014,p397_color_image0.jpg,117,0,72,72,,,,
2015,p398_color_image0.jpg,117,-7,69,76,,,,
2016,p399_color_image0.jpg,117,-6,65,71,,,,
2017,p403_color_image0.jpg,117,-4,71,75,,,,
2018,p412_color_image0.jpg,117,0,72,72,,,,
2019,p415_color_image0.jpg,117,1,71,70,,,,
2020,p422_color_image0.jpg,117,15,71,56,,,,
2021,p424_color_image0.jpg,117,9,78,69,,,,
2022,p425_color_image0.jpg,117,-2,73,75,,,,
2023,p430_color_image0.jpg,117,-2,75,77,,,,
2024,p431_color_image0.jpg,117,-2,70,72,,,,
2025,p432_color_image0.jpg,117,-2,74,76,,,,
2026,p435_color_image0.jpg,117,-1,72,73,,,,
2027,p438_color_image0.jpg,117,-6,72,78,,,,
2028,P439_color_image0.jpg,117,5,75,70,,,,
2029,p440_color_image0.jpg,117,-5,72,77,,,,
2030,p441_color_image0.jpg,117,2,72,70,,,,
2031,p442_color_image0.jpg,117,3,74,71,,,,
2032,p445_color_image0.jpg,117,-6,69,75,,,,
2033,p452_color_image0.jpg,117,-4,74,78,,,,
2034,p454_color_image0.jpg,117,3,71,68,,,,
2035,p462_color_image0.jpg,117,-8,69,77,,,,
2036,P467_color_image0.jpg,117,-3,72,75,,,,
2037,p469_color_image0.jpg,117,-11,66,77,,,,
2038,P472_color_image0.jpg,117,0,76,76,,,,
2039,p474_color_image0.jpg,117,1,71,70,,,,
2040,p477_color_image0.jpg,117,-1,75,76,,,,
2041,P481_color_image0.jpg,117,-1,74,75,,,,
2042,P482_color_image0.jpg,117,-6,66,72,,,,
2043,P484_color_image0.jpg,117,3,68,65,,,,
2044,P485_color_image0.jpg,117,16,80,64,,,,
2045,P491_color_image0.jpg,117,-12,65,77,,,,
2046,P495_color_image0.jpg,117,6,75,69,,,,
2047,P499_color_image0.jpg,117,5,68,63,,,,
2048,P501_color_image0.jpg,117,-6,65,71,,,,
2049,P505_color_image0.jpg,117,6,74,68,,,,
2050,P507_color_image0.jpg,117,-5,71,76,,,,
2051,P509_color_image0.jpg,117,-7,71,78,,,,
2052,P510_color_image0.jpg,117,-4,73,77,,,,
2053,P515_color_image0.jpg,117,8,81,73,,,,
2054,P518_color_image0.jpg,117,-12,66,78,,,,
2055,P519_color_image0.jpg,117,8,78,70,,,,
2056,P521_color_image0.jpg,117,3,67,64,,,,
2057,P525_color_image0.jpg,117,-2,74,76,,,,
2058,P529_color_image0.jpg,117,4,72,68,,,,
2059,P551_color_image0.jpg,117,6,81,75,,,,
2060,P556_color_image0.jpg,117,4,75,71,,,,
2061,P557_color_image0.jpg,117,7,78,71,,,,
2062,P564_color_image0.jpg,117,-1,66,67,,,,
2063,P565_color_image0.jpg,117,9,72,63,,,,
2064,P572_color_image0.jpg,117,-3,75,78,,,,
2065,P575_color_image0.jpg,117,13,71,58,,,,
2066,P576_color_image0.jpg,117,4,71,67,,,,
2067,P577_color_image0.jpg,117,-5,72,77,,,,
2068,P578_color_image0.jpg,117,5,74,69,,,,
2069,P582_color_image0.jpg,117,-5,64,69,,,,
2070,P585_color_image0.jpg,117,3,74,71,,,,
2071,P586_color_image0.jpg,117,-9,69,78,,,,
2072,P592_color_image0.jpg,117,-9,60,69,,,,
2073,P594_color_image0.jpg,117,-13,65,78,,,,
2074,P596_color_image0.jpg,117,8,80,72,,,,
2075,P601_color_image0.jpg,117,-12,60,72,,,,
2076,P602_color_image0.jpg,117,4,73,69,,,,
2077,P605_color_image0.jpg,117,0,71,71,,,,
2078,P606_color_image0.jpg,117,-4,73,77,,,,
2079,P609_color_image0.jpg,117,1,72,71,,,,
2080,P612_color_image0.jpg,117,-3,72,75,,,,
2081,P617_color_image0.jpg,117,0,74,74,,,,
2082,P618-1_color_image0.jpg,117,0,74,74,,,,
2083,P619_color_image0.jpg,117,-5,72,77,,,,
2084,P622_color_image0.jpg,117,5,80,75,,,,
2085,P632_color_image0.jpg,117,-5,74,79,,,,
2086,P635_color_image0.jpg,117,-12,65,77,,,,
2087,P636_color_image0.jpg,117,-1,72,73,,,,
2088,P638_color_image0.jpg,117,2,75,73,,,,
2089,P645_color_image0.jpg,117,-11,65,76,,,,
2090,P651_color_image0.jpg,117,0,72,72,,,,
2091,P653_color_image0.jpg,117,-8,69,77,,,,
2092,P673_color_image0.jpg,117,-14,63,77,,,,
2093,P674_color_image0.jpg,117,-1,72,73,,,,
2094,P676_color_image0.jpg,117,10,74,64,,,,
2095,P677_color_image0.jpg,117,-7,71,78,,,,
2096,P680_color_image0.jpg,117,-6,63,69,,,,
2097,P681_color_image0.jpg,117,2,74,72,,,,
2098,P690_color_image0.jpg,117,0,63,63,,,,
2099,P694_color_image0.jpg,117,-13,64,77,,,,
2100,P703_color_image0.jpg,117,-3,63,66,,,,
2101,P704_color_image0.jpg,117,2,74,72,,,,
2102,P710_color_image0.jpg,117,4,74,70,,,,
2103,P712_color_image0.jpg,117,0,68,68,,,,
2104,P717_color_image0.jpg,117,3,74,71,,,,
2105,P724_color_image0.jpg,117,7,74,67,,,,
2106,P728_color_image0.jpg,117,-3,74,77,,,,
2107,P742-1_color_image0.jpg,117,2,71,69,,,,
2108,P744_color_image0.jpg,117,-10,63,73,,,,
2109,P745-1_color_image0.jpg,117,-3,68,71,,,,
2110,P747_color_image0.jpg,117,7,72,65,,,,
2111,P759-1_color_image0.jpg,117,-9,69,78,,,,
2112,P766-1_color_image0.jpg,117,13,69,56,,,,
2113,P776-1_color_image0.jpg,117,5,73,68,,,,
2114,p172_color_image0.jpg,118,-7,66,73,-1.304635762,,,
2115,p175_color_image0.jpg,118,-2,75,77,,,,
2116,P188_color_image0.jpg,118,-4,72,76,,,,
2117,p191_color_image0.jpg,118,2,72,70,,,,
2118,p196_color_image0.jpg,118,-11,60,71,,,,
2119,p197_color_image0.jpg,118,-6,71,77,,,,
2120,p198_color_image0.jpg,118,-8,64,72,,,,
2121,p200_color_image0.jpg,118,-7,70,77,,,,
2122,P210_color_image0.jpg,118,-1,77,78,,,,
2123,p211_color_image0.jpg,118,4,79,75,,,,
2124,P220_color_image0.jpg,118,0,70,70,,,,
2125,p222_color_image0.jpg,118,5,74,69,,,,
2126,p223_color_image0.jpg,118,-2,63,65,,,,
2127,p230_color_image0.jpg,118,11,69,58,,,,
2128,p232-2_color_image0.jpg,118,-1,74,75,,,,
2129,p237-1_color_image0.jpg,118,-7,66,73,,,,
2130,p240_color_image0.jpg,118,-15,64,79,,,,
2131,p249_color_image0.jpg,118,-2,74,76,,,,
2132,p250_color_image0.jpg,118,0,68,68,,,,
2133,p253_color_image0.jpg,118,-5,71,76,,,,
2134,p255_color_image0.jpg,118,-2,72,74,,,,
2135,p256_color_image0.jpg,118,0,71,71,,,,
2136,p260_color_image0.jpg,118,-7,69,76,,,,
2137,p261_color_image0.jpg,118,-1,71,72,,,,
2138,p263_color_image0.jpg,118,1,69,68,,,,
2139,P267_color_image0.jpg,118,3,71,68,,,,
2140,p272_color_image0.jpg,118,-4,68,72,,,,
2141,p279_color_image0.jpg,118,8,71,63,,,,
2142,P280_color_image0.jpg,118,0,72,72,,,,
2143,P282_color_image0.jpg,118,0,72,72,,,,
2144,p284_color_image0.jpg,118,-4,71,75,,,,
2145,p287_color_image0.jpg,118,1,72,71,,,,
2146,p288_color_image0.jpg,118,-11,67,78,,,,
2147,p289_color_image0.jpg,118,10,81,71,,,,
2148,p302_color_image0.jpg,118,6,78,72,,,,
2149,p306_color_image0.jpg,118,1,71,70,,,,
2150,p311_color_image0.jpg,118,3,81,78,,,,
2151,P321_color_image0.jpg,118,-5,72,77,,,,
2152,p327_color_image0.jpg,118,-5,72,77,,,,
2153,p344_color_image0.jpg,118,1,71,70,,,,
2154,p345_color_image0.jpg,118,5,72,67,,,,
2155,p346-1_color_image0.jpg,118,-5,63,68,,,,
2156,p347_color_image0.jpg,118,-2,71,73,,,,
2157,p351_color_image0.jpg,118,2,72,70,,,,
2158,P354_color_image0.jpg,118,-9,68,77,,,,
2159,p362_color_image0.jpg,118,-4,71,75,,,,
2160,p366_color_image0.jpg,118,-12,66,78,,,,
2161,p368_color_image0.jpg,118,2,70,68,,,,
2162,p378_color_image0.jpg,118,-16,62,78,,,,
2163,p386_color_image0.jpg,118,-6,71,77,,,,
2164,P395_color_image0.jpg,118,-9,68,77,,,,
2165,p397_color_image0.jpg,118,0,72,72,,,,
2166,p398_color_image0.jpg,118,-8,68,76,,,,
2167,p399_color_image0.jpg,118,1,72,71,,,,
2168,p403_color_image0.jpg,118,3,78,75,,,,
2169,p412_color_image0.jpg,118,-6,66,72,,,,
2170,p415_color_image0.jpg,118,2,72,70,,,,
2171,p422_color_image0.jpg,118,10,66,56,,,,
2172,p424_color_image0.jpg,118,10,79,69,,,,
2173,p425_color_image0.jpg,118,3,78,75,,,,
2174,p430_color_image0.jpg,118,-9,68,77,,,,
2175,p431_color_image0.jpg,118,-2,70,72,,,,
2176,p432_color_image0.jpg,118,-2,74,76,,,,
2177,p435_color_image0.jpg,118,-1,72,73,,,,
2178,p438_color_image0.jpg,118,-12,66,78,,,,
2179,P439_color_image0.jpg,118,10,80,70,,,,
2180,p440_color_image0.jpg,118,-5,72,77,,,,
2181,p441_color_image0.jpg,118,2,72,70,,,,
2182,p442_color_image0.jpg,118,0,71,71,,,,
2183,p445_color_image0.jpg,118,-3,72,75,,,,
2184,p452_color_image0.jpg,118,-2,76,78,,,,
2185,p454_color_image0.jpg,118,-6,62,68,,,,
2186,p462_color_image0.jpg,118,-11,66,77,,,,
2187,P467_color_image0.jpg,118,-7,68,75,,,,
2188,p469_color_image0.jpg,118,3,80,77,,,,
2189,P472_color_image0.jpg,118,-4,72,76,,,,
2190,p474_color_image0.jpg,118,-1,69,70,,,,
2191,p477_color_image0.jpg,118,-3,73,76,,,,
2192,P481_color_image0.jpg,118,4,79,75,,,,
2193,P482_color_image0.jpg,118,-12,60,72,,,,
2194,P484_color_image0.jpg,118,14,79,65,,,,
2195,P485_color_image0.jpg,118,17,81,64,,,,
2196,P491_color_image0.jpg,118,-5,72,77,,,,
2197,P495_color_image0.jpg,118,16,85,69,,,,
2198,P499_color_image0.jpg,118,9,72,63,,,,
2199,P501_color_image0.jpg,118,-5,66,71,,,,
2200,P505_color_image0.jpg,118,0,68,68,,,,
2201,P507_color_image0.jpg,118,-6,70,76,,,,
2202,P509_color_image0.jpg,118,-13,65,78,,,,
2203,P510_color_image0.jpg,118,-3,74,77,,,,
2204,P515_color_image0.jpg,118,1,74,73,,,,
2205,P518_color_image0.jpg,118,-6,72,78,,,,
2206,P519_color_image0.jpg,118,2,72,70,,,,
2207,P521_color_image0.jpg,118,6,70,64,,,,
2208,P525_color_image0.jpg,118,-5,71,76,,,,
2209,P529_color_image0.jpg,118,-8,60,68,,,,
2210,P551_color_image0.jpg,118,-6,69,75,,,,
2211,P556_color_image0.jpg,118,-6,65,71,,,,
2212,P557_color_image0.jpg,118,3,74,71,,,,
2213,P564_color_image0.jpg,118,0,67,67,,,,
2214,P565_color_image0.jpg,118,7,70,63,,,,
2215,P572_color_image0.jpg,118,-3,75,78,,,,
2216,P575_color_image0.jpg,118,10,68,58,,,,
2217,P576_color_image0.jpg,118,5,72,67,,,,
2218,P577_color_image0.jpg,118,-5,72,77,,,,
2219,P578_color_image0.jpg,118,3,72,69,,,,
2220,P582_color_image0.jpg,118,6,75,69,,,,
2221,P585_color_image0.jpg,118,0,71,71,,,,
2222,P586_color_image0.jpg,118,-6,72,78,,,,
2223,P592_color_image0.jpg,118,-5,64,69,,,,
2224,P594_color_image0.jpg,118,-13,65,78,,,,
2225,P596_color_image0.jpg,118,1,73,72,,,,
2226,P601_color_image0.jpg,118,-2,70,72,,,,
2227,P602_color_image0.jpg,118,7,76,69,,,,
2228,P605_color_image0.jpg,118,1,72,71,,,,
2229,P606_color_image0.jpg,118,-2,75,77,,,,
2230,P609_color_image0.jpg,118,3,74,71,,,,
2231,P612_color_image0.jpg,118,-6,69,75,,,,
2232,P617_color_image0.jpg,118,0,74,74,,,,
2233,P618-1_color_image0.jpg,118,-2,72,74,,,,
2234,P619_color_image0.jpg,118,-11,66,77,,,,
2235,P622_color_image0.jpg,118,-3,72,75,,,,
2236,P632_color_image0.jpg,118,-10,69,79,,,,
2237,P635_color_image0.jpg,118,-8,69,77,,,,
2238,P636_color_image0.jpg,118,4,77,73,,,,
2239,P638_color_image0.jpg,118,6,79,73,,,,
2240,P645_color_image0.jpg,118,-8,68,76,,,,
2241,P651_color_image0.jpg,118,-1,71,72,,,,
2242,P653_color_image0.jpg,118,1,78,77,,,,
2243,P673_color_image0.jpg,118,-6,71,77,,,,
2244,P674_color_image0.jpg,118,-13,60,73,,,,
2245,P676_color_image0.jpg,118,8,72,64,,,,
2246,P677_color_image0.jpg,118,-8,70,78,,,,
2247,P680_color_image0.jpg,118,-1,68,69,,,,
2248,P681_color_image0.jpg,118,0,72,72,,,,
2249,P690_color_image0.jpg,118,-3,60,63,,,,
2250,P694_color_image0.jpg,118,-7,70,77,,,,
2251,P703_color_image0.jpg,118,6,72,66,,,,
2252,P704_color_image0.jpg,118,5,77,72,,,,
2253,P710_color_image0.jpg,118,-10,60,70,,,,
2254,P712_color_image0.jpg,118,0,68,68,,,,
2255,P717_color_image0.jpg,118,-3,68,71,,,,
2256,P724_color_image0.jpg,118,4,71,67,,,,
2257,P728_color_image0.jpg,118,1,78,77,,,,
2258,P742-1_color_image0.jpg,118,5,74,69,,,,
2259,P744_color_image0.jpg,118,-1,72,73,,,,
2260,P745-1_color_image0.jpg,118,-5,66,71,,,,
2261,P747_color_image0.jpg,118,13,78,65,,,,
2262,P759-1_color_image0.jpg,118,-11,67,78,,,,
2263,P766-1_color_image0.jpg,118,12,68,56,,,,
2264,P776-1_color_image0.jpg,118,4,72,68,,,,
2265,p172_color_image0.jpg,119,-7,66,73,0.350993377,,,
2266,p175_color_image0.jpg,119,-2,75,77,,,,
2267,P188_color_image0.jpg,119,-2,74,76,,,,
2268,p191_color_image0.jpg,119,2,72,70,,,,
2269,p196_color_image0.jpg,119,-7,64,71,,,,
2270,p197_color_image0.jpg,119,-10,67,77,,,,
2271,p198_color_image0.jpg,119,-3,69,72,,,,
2272,p200_color_image0.jpg,119,-2,75,77,,,,
2273,P210_color_image0.jpg,119,-3,75,78,,,,
2274,p211_color_image0.jpg,119,-1,74,75,,,,
2275,P220_color_image0.jpg,119,3,73,70,,,,
2276,p222_color_image0.jpg,119,4,73,69,,,,
2277,p223_color_image0.jpg,119,3,68,65,,,,
2278,p230_color_image0.jpg,119,9,67,58,,,,
2279,p232-2_color_image0.jpg,119,-1,74,75,,,,
2280,p237-1_color_image0.jpg,119,-3,70,73,,,,
2281,p240_color_image0.jpg,119,-7,72,79,,,,
2282,p249_color_image0.jpg,119,-2,74,76,,,,
2283,p250_color_image0.jpg,119,1,69,68,,,,
2284,p253_color_image0.jpg,119,-5,71,76,,,,
2285,p255_color_image0.jpg,119,-2,72,74,,,,
2286,p256_color_image0.jpg,119,1,72,71,,,,
2287,p260_color_image0.jpg,119,-3,73,76,,,,
2288,p261_color_image0.jpg,119,-1,71,72,,,,
2289,p263_color_image0.jpg,119,3,71,68,,,,
2290,P267_color_image0.jpg,119,1,69,68,,,,
2291,p272_color_image0.jpg,119,-1,71,72,,,,
2292,p279_color_image0.jpg,119,9,72,63,,,,
2293,P280_color_image0.jpg,119,2,74,72,,,,
2294,P282_color_image0.jpg,119,3,75,72,,,,
2295,p284_color_image0.jpg,119,-4,71,75,,,,
2296,p287_color_image0.jpg,119,3,74,71,,,,
2297,p288_color_image0.jpg,119,-7,71,78,,,,
2298,p289_color_image0.jpg,119,-2,69,71,,,,
2299,p302_color_image0.jpg,119,7,79,72,,,,
2300,p306_color_image0.jpg,119,5,75,70,,,,
2301,p311_color_image0.jpg,119,-3,75,78,,,,
2302,P321_color_image0.jpg,119,-3,74,77,,,,
2303,p327_color_image0.jpg,119,-5,72,77,,,,
2304,p344_color_image0.jpg,119,2,72,70,,,,
2305,p345_color_image0.jpg,119,4,71,67,,,,
2306,p346-1_color_image0.jpg,119,0,68,68,,,,
2307,p347_color_image0.jpg,119,-2,71,73,,,,
2308,p351_color_image0.jpg,119,2,72,70,,,,
2309,P354_color_image0.jpg,119,-5,72,77,,,,
2310,p362_color_image0.jpg,119,-4,71,75,,,,
2311,p366_color_image0.jpg,119,-9,69,78,,,,
2312,p368_color_image0.jpg,119,4,72,68,,,,
2313,p378_color_image0.jpg,119,-6,72,78,,,,
2314,p386_color_image0.jpg,119,-7,70,77,,,,
2315,P395_color_image0.jpg,119,-6,71,77,,,,
2316,p397_color_image0.jpg,119,0,72,72,,,,
2317,p398_color_image0.jpg,119,-5,71,76,,,,
2318,p399_color_image0.jpg,119,0,71,71,,,,
2319,p403_color_image0.jpg,119,-3,72,75,,,,
2320,p412_color_image0.jpg,119,3,75,72,,,,
2321,p415_color_image0.jpg,119,2,72,70,,,,
2322,p422_color_image0.jpg,119,15,71,56,,,,
2323,p424_color_image0.jpg,119,3,72,69,,,,
2324,p425_color_image0.jpg,119,-3,72,75,,,,
2325,p430_color_image0.jpg,119,-6,71,77,,,,
2326,p431_color_image0.jpg,119,6,78,72,,,,
2327,p432_color_image0.jpg,119,-2,74,76,,,,
2328,p435_color_image0.jpg,119,-2,71,73,,,,
2329,p438_color_image0.jpg,119,-7,71,78,,,,
2330,P439_color_image0.jpg,119,4,74,70,,,,
2331,p440_color_image0.jpg,119,-4,73,77,,,,
2332,p441_color_image0.jpg,119,4,74,70,,,,
2333,p442_color_image0.jpg,119,3,74,71,,,,
2334,p445_color_image0.jpg,119,4,79,75,,,,
2335,p452_color_image0.jpg,119,-6,72,78,,,,
2336,p454_color_image0.jpg,119,-1,67,68,,,,
2337,p462_color_image0.jpg,119,-3,74,77,,,,
2338,P467_color_image0.jpg,119,-4,71,75,,,,
2339,p469_color_image0.jpg,119,3,80,77,,,,
2340,P472_color_image0.jpg,119,-2,74,76,,,,
2341,p474_color_image0.jpg,119,2,72,70,,,,
2342,p477_color_image0.jpg,119,10,86,76,,,,
2343,P481_color_image0.jpg,119,3,78,75,,,,
2344,P482_color_image0.jpg,119,4,76,72,,,,
2345,P484_color_image0.jpg,119,6,71,65,,,,
2346,P485_color_image0.jpg,119,16,80,64,,,,
2347,P491_color_image0.jpg,119,-5,72,77,,,,
2348,P495_color_image0.jpg,119,17,86,69,,,,
2349,P499_color_image0.jpg,119,9,72,63,,,,
2350,P501_color_image0.jpg,119,-3,68,71,,,,
2351,P505_color_image0.jpg,119,-1,67,68,,,,
2352,P507_color_image0.jpg,119,-6,70,76,,,,
2353,P509_color_image0.jpg,119,-13,65,78,,,,
2354,P510_color_image0.jpg,119,-5,72,77,,,,
2355,P515_color_image0.jpg,119,9,82,73,,,,
2356,P518_color_image0.jpg,119,-6,72,78,,,,
2357,P519_color_image0.jpg,119,4,74,70,,,,
2358,P521_color_image0.jpg,119,8,72,64,,,,
2359,P525_color_image0.jpg,119,-4,72,76,,,,
2360,P529_color_image0.jpg,119,3,71,68,,,,
2361,P551_color_image0.jpg,119,5,80,75,,,,
2362,P556_color_image0.jpg,119,-2,69,71,,,,
2363,P557_color_image0.jpg,119,1,72,71,,,,
2364,P564_color_image0.jpg,119,-4,63,67,,,,
2365,P565_color_image0.jpg,119,5,68,63,,,,
2366,P572_color_image0.jpg,119,-4,74,78,,,,
2367,P575_color_image0.jpg,119,15,73,58,,,,
2368,P576_color_image0.jpg,119,3,70,67,,,,
2369,P577_color_image0.jpg,119,-5,72,77,,,,
2370,P578_color_image0.jpg,119,5,74,69,,,,
2371,P582_color_image0.jpg,119,5,74,69,,,,
2372,P585_color_image0.jpg,119,2,73,71,,,,
2373,P586_color_image0.jpg,119,-5,73,78,,,,
2374,P592_color_image0.jpg,119,2,71,69,,,,
2375,P594_color_image0.jpg,119,0,78,78,,,,
2376,P596_color_image0.jpg,119,10,82,72,,,,
2377,P601_color_image0.jpg,119,0,72,72,,,,
2378,P602_color_image0.jpg,119,5,74,69,,,,
2379,P605_color_image0.jpg,119,0,71,71,,,,
2380,P606_color_image0.jpg,119,-5,72,77,,,,
2381,P609_color_image0.jpg,119,3,74,71,,,,
2382,P612_color_image0.jpg,119,-4,71,75,,,,
2383,P617_color_image0.jpg,119,0,74,74,,,,
2384,P618-1_color_image0.jpg,119,-3,71,74,,,,
2385,P619_color_image0.jpg,119,1,78,77,,,,
2386,P622_color_image0.jpg,119,7,82,75,,,,
2387,P632_color_image0.jpg,119,-8,71,79,,,,
2388,P635_color_image0.jpg,119,-9,68,77,,,,
2389,P636_color_image0.jpg,119,-2,71,73,,,,
2390,P638_color_image0.jpg,119,1,74,73,,,,
2391,P645_color_image0.jpg,119,-4,72,76,,,,
2392,P651_color_image0.jpg,119,5,77,72,,,,
2393,P653_color_image0.jpg,119,-7,70,77,,,,
2394,P673_color_image0.jpg,119,-9,68,77,,,,
2395,P674_color_image0.jpg,119,7,80,73,,,,
2396,P676_color_image0.jpg,119,15,79,64,,,,
2397,P677_color_image0.jpg,119,-7,71,78,,,,
2398,P680_color_image0.jpg,119,-3,66,69,,,,
2399,P681_color_image0.jpg,119,8,80,72,,,,
2400,P690_color_image0.jpg,119,9,72,63,,,,
2401,P694_color_image0.jpg,119,-9,68,77,,,,
2402,P703_color_image0.jpg,119,6,72,66,,,,
2403,P704_color_image0.jpg,119,5,77,72,,,,
2404,P710_color_image0.jpg,119,-4,66,70,,,,
2405,P712_color_image0.jpg,119,0,68,68,,,,
2406,P717_color_image0.jpg,119,0,71,71,,,,
2407,P724_color_image0.jpg,119,4,71,67,,,,
2408,P728_color_image0.jpg,119,-3,74,77,,,,
2409,P742-1_color_image0.jpg,119,6,75,69,,,,
2410,P744_color_image0.jpg,119,1,74,73,,,,
2411,P745-1_color_image0.jpg,119,-1,70,71,,,,
2412,P747_color_image0.jpg,119,9,74,65,,,,
2413,P759-1_color_image0.jpg,119,-6,72,78,,,,
2414,P766-1_color_image0.jpg,119,15,71,56,,,,
2415,P776-1_color_image0.jpg,119,7,75,68,,,,
2416,p172_color_image0.jpg,121,-5,68,73,0.324503311,,,
2417,p175_color_image0.jpg,121,-1,76,77,,,,
2418,P188_color_image0.jpg,121,-1,75,76,,,,
2419,p191_color_image0.jpg,121,1,71,70,,,,
2420,p196_color_image0.jpg,121,-8,63,71,,,,
2421,p197_color_image0.jpg,121,-3,74,77,,,,
2422,p198_color_image0.jpg,121,-3,69,72,,,,
2423,p200_color_image0.jpg,121,-3,74,77,,,,
2424,P210_color_image0.jpg,121,-6,72,78,,,,
2425,p211_color_image0.jpg,121,3,78,75,,,,
2426,P220_color_image0.jpg,121,4,74,70,,,,
2427,p222_color_image0.jpg,121,3,72,69,,,,
2428,p223_color_image0.jpg,121,5,70,65,,,,
2429,p230_color_image0.jpg,121,14,72,58,,,,
2430,p232-2_color_image0.jpg,121,0,75,75,,,,
2431,p237-1_color_image0.jpg,121,-4,69,73,,,,
2432,p240_color_image0.jpg,121,-8,71,79,,,,
2433,p249_color_image0.jpg,121,0,76,76,,,,
2434,p250_color_image0.jpg,121,2,70,68,,,,
2435,p253_color_image0.jpg,121,-4,72,76,,,,
2436,p255_color_image0.jpg,121,3,77,74,,,,
2437,p256_color_image0.jpg,121,1,72,71,,,,
2438,p260_color_image0.jpg,121,2,78,76,,,,
2439,p261_color_image0.jpg,121,0,72,72,,,,
2440,p263_color_image0.jpg,121,3,71,68,,,,
2441,P267_color_image0.jpg,121,3,71,68,,,,
2442,p272_color_image0.jpg,121,-1,71,72,,,,
2443,p279_color_image0.jpg,121,11,74,63,,,,
2444,P280_color_image0.jpg,121,-7,65,72,,,,
2445,P282_color_image0.jpg,121,7,79,72,,,,
2446,p284_color_image0.jpg,121,-3,72,75,,,,
2447,p287_color_image0.jpg,121,1,72,71,,,,
2448,p288_color_image0.jpg,121,-7,71,78,,,,
2449,p289_color_image0.jpg,121,1,72,71,,,,
2450,p302_color_image0.jpg,121,8,80,72,,,,
2451,p306_color_image0.jpg,121,2,72,70,,,,
2452,p311_color_image0.jpg,121,0,78,78,,,,
2453,P321_color_image0.jpg,121,0,77,77,,,,
2454,p327_color_image0.jpg,121,-3,74,77,,,,
2455,p344_color_image0.jpg,121,2,72,70,,,,
2456,p345_color_image0.jpg,121,5,72,67,,,,
2457,p346-1_color_image0.jpg,121,-5,63,68,,,,
2458,p347_color_image0.jpg,121,0,73,73,,,,
2459,p351_color_image0.jpg,121,3,73,70,,,,
2460,P354_color_image0.jpg,121,-6,71,77,,,,
2461,p362_color_image0.jpg,121,-4,71,75,,,,
2462,p366_color_image0.jpg,121,-1,77,78,,,,
2463,p368_color_image0.jpg,121,2,70,68,,,,
2464,p378_color_image0.jpg,121,-7,71,78,,,,
2465,p386_color_image0.jpg,121,-6,71,77,,,,
2466,P395_color_image0.jpg,121,-7,70,77,,,,
2467,p397_color_image0.jpg,121,0,72,72,,,,
2468,p398_color_image0.jpg,121,-7,69,76,,,,
2469,p399_color_image0.jpg,121,1,72,71,,,,
2470,p403_color_image0.jpg,121,-3,72,75,,,,
2471,p412_color_image0.jpg,121,-8,64,72,,,,
2472,p415_color_image0.jpg,121,4,74,70,,,,
2473,p422_color_image0.jpg,121,10,66,56,,,,
2474,p424_color_image0.jpg,121,9,78,69,,,,
2475,p425_color_image0.jpg,121,-1,74,75,,,,
2476,p430_color_image0.jpg,121,3,80,77,,,,
2477,p431_color_image0.jpg,121,5,77,72,,,,
2478,p432_color_image0.jpg,121,-2,74,76,,,,
2479,p435_color_image0.jpg,121,0,73,73,,,,
2480,p438_color_image0.jpg,121,-13,65,78,,,,
2481,P439_color_image0.jpg,121,2,72,70,,,,
2482,p440_color_image0.jpg,121,-5,72,77,,,,
2483,p441_color_image0.jpg,121,2,72,70,,,,
2484,p442_color_image0.jpg,121,8,79,71,,,,
2485,p445_color_image0.jpg,121,3,78,75,,,,
2486,p452_color_image0.jpg,121,-11,67,78,,,,
2487,p454_color_image0.jpg,121,-2,66,68,,,,
2488,p462_color_image0.jpg,121,2,79,77,,,,
2489,P467_color_image0.jpg,121,3,78,75,,,,
2490,p469_color_image0.jpg,121,4,81,77,,,,
2491,P472_color_image0.jpg,121,-2,74,76,,,,
2492,p474_color_image0.jpg,121,5,75,70,,,,
2493,p477_color_image0.jpg,121,4,80,76,,,,
2494,P481_color_image0.jpg,121,3,78,75,,,,
2495,P482_color_image0.jpg,121,-7,65,72,,,,
2496,P484_color_image0.jpg,121,7,72,65,,,,
2497,P485_color_image0.jpg,121,16,80,64,,,,
2498,P491_color_image0.jpg,121,-5,72,77,,,,
2499,P495_color_image0.jpg,121,11,80,69,,,,
2500,P499_color_image0.jpg,121,8,71,63,,,,
2501,P501_color_image0.jpg,121,-3,68,71,,,,
2502,P505_color_image0.jpg,121,8,76,68,,,,
2503,P507_color_image0.jpg,121,-5,71,76,,,,
2504,P509_color_image0.jpg,121,-13,65,78,,,,
2505,P510_color_image0.jpg,121,1,78,77,,,,
2506,P515_color_image0.jpg,121,7,80,73,,,,
2507,P518_color_image0.jpg,121,-4,74,78,,,,
2508,P519_color_image0.jpg,121,1,71,70,,,,
2509,P521_color_image0.jpg,121,6,70,64,,,,
2510,P525_color_image0.jpg,121,-4,72,76,,,,
2511,P529_color_image0.jpg,121,-6,62,68,,,,
2512,P551_color_image0.jpg,121,0,75,75,,,,
2513,P556_color_image0.jpg,121,-6,65,71,,,,
2514,P557_color_image0.jpg,121,7,78,71,,,,
2515,P564_color_image0.jpg,121,-2,65,67,,,,
2516,P565_color_image0.jpg,121,5,68,63,,,,
2517,P572_color_image0.jpg,121,-4,74,78,,,,
2518,P575_color_image0.jpg,121,11,69,58,,,,
2519,P576_color_image0.jpg,121,10,77,67,,,,
2520,P577_color_image0.jpg,121,-5,72,77,,,,
2521,P578_color_image0.jpg,121,5,74,69,,,,
2522,P582_color_image0.jpg,121,5,74,69,,,,
2523,P585_color_image0.jpg,121,1,72,71,,,,
2524,P586_color_image0.jpg,121,-4,74,78,,,,
2525,P592_color_image0.jpg,121,2,71,69,,,,
2526,P594_color_image0.jpg,121,-13,65,78,,,,
2527,P596_color_image0.jpg,121,3,75,72,,,,
2528,P601_color_image0.jpg,121,0,72,72,,,,
2529,P602_color_image0.jpg,121,3,72,69,,,,
2530,P605_color_image0.jpg,121,1,72,71,,,,
2531,P606_color_image0.jpg,121,-4,73,77,,,,
2532,P609_color_image0.jpg,121,4,75,71,,,,
2533,P612_color_image0.jpg,121,3,78,75,,,,
2534,P617_color_image0.jpg,121,1,75,74,,,,
2535,P618-1_color_image0.jpg,121,3,77,74,,,,
2536,P619_color_image0.jpg,121,-2,75,77,,,,
2537,P622_color_image0.jpg,121,-2,73,75,,,,
2538,P632_color_image0.jpg,121,-9,70,79,,,,
2539,P635_color_image0.jpg,121,-6,71,77,,,,
2540,P636_color_image0.jpg,121,7,80,73,,,,
2541,P638_color_image0.jpg,121,3,76,73,,,,
2542,P645_color_image0.jpg,121,1,77,76,,,,
2543,P651_color_image0.jpg,121,-1,71,72,,,,
2544,P653_color_image0.jpg,121,-8,69,77,,,,
2545,P673_color_image0.jpg,121,-5,72,77,,,,
2546,P674_color_image0.jpg,121,5,78,73,,,,
2547,P676_color_image0.jpg,121,10,74,64,,,,
2548,P677_color_image0.jpg,121,-11,67,78,,,,
2549,P680_color_image0.jpg,121,2,71,69,,,,
2550,P681_color_image0.jpg,121,2,74,72,,,,
2551,P690_color_image0.jpg,121,9,72,63,,,,
2552,P694_color_image0.jpg,121,-11,66,77,,,,
2553,P703_color_image0.jpg,121,2,68,66,,,,
2554,P704_color_image0.jpg,121,0,72,72,,,,
2555,P710_color_image0.jpg,121,5,75,70,,,,
2556,P712_color_image0.jpg,121,-2,66,68,,,,
2557,P717_color_image0.jpg,121,4,75,71,,,,
2558,P724_color_image0.jpg,121,2,69,67,,,,
2559,P728_color_image0.jpg,121,-3,74,77,,,,
2560,P742-1_color_image0.jpg,121,2,71,69,,,,
2561,P744_color_image0.jpg,121,2,75,73,,,,
2562,P745-1_color_image0.jpg,121,-3,68,71,,,,
2563,P747_color_image0.jpg,121,9,74,65,,,,
2564,P759-1_color_image0.jpg,121,-6,72,78,,,,
2565,P766-1_color_image0.jpg,121,10,66,56,,,,
2566,P776-1_color_image0.jpg,121,2,70,68,,,,
2567,p172_color_image0.jpg,122,-7,66,73,0.549668874,,,
2568,p175_color_image0.jpg,122,-3,74,77,,,,
2569,P188_color_image0.jpg,122,6,82,76,,,,
2570,p191_color_image0.jpg,122,4,74,70,,,,
2571,p196_color_image0.jpg,122,-6,65,71,,,,
2572,p197_color_image0.jpg,122,3,80,77,,,,
2573,p198_color_image0.jpg,122,-5,67,72,,,,
2574,p200_color_image0.jpg,122,-5,72,77,,,,
2575,P210_color_image0.jpg,122,-13,65,78,,,,
2576,p211_color_image0.jpg,122,-4,71,75,,,,
2577,P220_color_image0.jpg,122,7,77,70,,,,
2578,p222_color_image0.jpg,122,3,72,69,,,,
2579,p223_color_image0.jpg,122,-2,63,65,,,,
2580,p230_color_image0.jpg,122,14,72,58,,,,
2581,p232-2_color_image0.jpg,122,-3,72,75,,,,
2582,p237-1_color_image0.jpg,122,6,79,73,,,,
2583,p240_color_image0.jpg,122,-10,69,79,,,,
2584,p249_color_image0.jpg,122,-5,71,76,,,,
2585,p250_color_image0.jpg,122,2,70,68,,,,
2586,p253_color_image0.jpg,122,-9,67,76,,,,
2587,p255_color_image0.jpg,122,0,74,74,,,,
2588,p256_color_image0.jpg,122,1,72,71,,,,
2589,p260_color_image0.jpg,122,4,80,76,,,,
2590,p261_color_image0.jpg,122,8,80,72,,,,
2591,p263_color_image0.jpg,122,4,72,68,,,,
2592,P267_color_image0.jpg,122,6,74,68,,,,
2593,p272_color_image0.jpg,122,0,72,72,,,,
2594,p279_color_image0.jpg,122,9,72,63,,,,
2595,P280_color_image0.jpg,122,-3,69,72,,,,
2596,P282_color_image0.jpg,122,8,80,72,,,,
2597,p284_color_image0.jpg,122,-3,72,75,,,,
2598,p287_color_image0.jpg,122,11,82,71,,,,
2599,p288_color_image0.jpg,122,-7,71,78,,,,
2600,p289_color_image0.jpg,122,5,76,71,,,,
2601,p302_color_image0.jpg,122,2,74,72,,,,
2602,p306_color_image0.jpg,122,4,74,70,,,,
2603,p311_color_image0.jpg,122,0,78,78,,,,
2604,P321_color_image0.jpg,122,-3,74,77,,,,
2605,p327_color_image0.jpg,122,-5,72,77,,,,
2606,p344_color_image0.jpg,122,2,72,70,,,,
2607,p345_color_image0.jpg,122,5,72,67,,,,
2608,p346-1_color_image0.jpg,122,-5,63,68,,,,
2609,p347_color_image0.jpg,122,7,80,73,,,,
2610,p351_color_image0.jpg,122,2,72,70,,,,
2611,P354_color_image0.jpg,122,-10,67,77,,,,
2612,p362_color_image0.jpg,122,-1,74,75,,,,
2613,p366_color_image0.jpg,122,0,78,78,,,,
2614,p368_color_image0.jpg,122,4,72,68,,,,
2615,p378_color_image0.jpg,122,2,80,78,,,,
2616,p386_color_image0.jpg,122,-8,69,77,,,,
2617,P395_color_image0.jpg,122,-3,74,77,,,,
2618,p397_color_image0.jpg,122,1,73,72,,,,
2619,p398_color_image0.jpg,122,-6,70,76,,,,
2620,p399_color_image0.jpg,122,-2,69,71,,,,
2621,p403_color_image0.jpg,122,-5,70,75,,,,
2622,p412_color_image0.jpg,122,9,81,72,,,,
2623,p415_color_image0.jpg,122,2,72,70,,,,
2624,p422_color_image0.jpg,122,22,78,56,,,,
2625,p424_color_image0.jpg,122,9,78,69,,,,
2626,p425_color_image0.jpg,122,-3,72,75,,,,
2627,p430_color_image0.jpg,122,8,85,77,,,,
2628,p431_color_image0.jpg,122,-3,69,72,,,,
2629,p432_color_image0.jpg,122,-2,74,76,,,,
2630,p435_color_image0.jpg,122,1,74,73,,,,
2631,p438_color_image0.jpg,122,-9,69,78,,,,
2632,P439_color_image0.jpg,122,2,72,70,,,,
2633,p440_color_image0.jpg,122,-5,72,77,,,,
2634,p441_color_image0.jpg,122,4,74,70,,,,
2635,p442_color_image0.jpg,122,7,78,71,,,,
2636,p445_color_image0.jpg,122,-3,72,75,,,,
2637,p452_color_image0.jpg,122,-6,72,78,,,,
2638,p454_color_image0.jpg,122,-4,64,68,,,,
2639,p462_color_image0.jpg,122,-9,68,77,,,,
2640,P467_color_image0.jpg,122,-3,72,75,,,,
2641,p469_color_image0.jpg,122,-2,75,77,,,,
2642,P472_color_image0.jpg,122,-1,75,76,,,,
2643,p474_color_image0.jpg,122,1,71,70,,,,
2644,p477_color_image0.jpg,122,10,86,76,,,,
2645,P481_color_image0.jpg,122,-3,72,75,,,,
2646,P482_color_image0.jpg,122,0,72,72,,,,
2647,P484_color_image0.jpg,122,7,72,65,,,,
2648,P485_color_image0.jpg,122,18,82,64,,,,
2649,P491_color_image0.jpg,122,-9,68,77,,,,
2650,P495_color_image0.jpg,122,11,80,69,,,,
2651,P499_color_image0.jpg,122,6,69,63,,,,
2652,P501_color_image0.jpg,122,-5,66,71,,,,
2653,P505_color_image0.jpg,122,10,78,68,,,,
2654,P507_color_image0.jpg,122,-5,71,76,,,,
2655,P509_color_image0.jpg,122,-3,75,78,,,,
2656,P510_color_image0.jpg,122,3,80,77,,,,
2657,P515_color_image0.jpg,122,3,76,73,,,,
2658,P518_color_image0.jpg,122,-7,71,78,,,,
2659,P519_color_image0.jpg,122,8,78,70,,,,
2660,P521_color_image0.jpg,122,8,72,64,,,,
2661,P525_color_image0.jpg,122,-2,74,76,,,,
2662,P529_color_image0.jpg,122,3,71,68,,,,
2663,P551_color_image0.jpg,122,-1,74,75,,,,
2664,P556_color_image0.jpg,122,16,87,71,,,,
2665,P557_color_image0.jpg,122,7,78,71,,,,
2666,P564_color_image0.jpg,122,-1,66,67,,,,
2667,P565_color_image0.jpg,122,9,72,63,,,,
2668,P572_color_image0.jpg,122,-1,77,78,,,,
2669,P575_color_image0.jpg,122,13,71,58,,,,
2670,P576_color_image0.jpg,122,2,69,67,,,,
2671,P577_color_image0.jpg,122,-5,72,77,,,,
2672,P578_color_image0.jpg,122,5,74,69,,,,
2673,P582_color_image0.jpg,122,5,74,69,,,,
2674,P585_color_image0.jpg,122,1,72,71,,,,
2675,P586_color_image0.jpg,122,-6,72,78,,,,
2676,P592_color_image0.jpg,122,-1,68,69,,,,
2677,P594_color_image0.jpg,122,-14,64,78,,,,
2678,P596_color_image0.jpg,122,5,77,72,,,,
2679,P601_color_image0.jpg,122,-9,63,72,,,,
2680,P602_color_image0.jpg,122,2,71,69,,,,
2681,P605_color_image0.jpg,122,-2,69,71,,,,
2682,P606_color_image0.jpg,122,-5,72,77,,,,
2683,P609_color_image0.jpg,122,1,72,71,,,,
2684,P612_color_image0.jpg,122,-1,74,75,,,,
2685,P617_color_image0.jpg,122,0,74,74,,,,
2686,P618-1_color_image0.jpg,122,0,74,74,,,,
2687,P619_color_image0.jpg,122,-3,74,77,,,,
2688,P622_color_image0.jpg,122,1,76,75,,,,
2689,P632_color_image0.jpg,122,-7,72,79,,,,
2690,P635_color_image0.jpg,122,-9,68,77,,,,
2691,P636_color_image0.jpg,122,-2,71,73,,,,
2692,P638_color_image0.jpg,122,-1,72,73,,,,
2693,P645_color_image0.jpg,122,-13,63,76,,,,
2694,P651_color_image0.jpg,122,-2,70,72,,,,
2695,P653_color_image0.jpg,122,-5,72,77,,,,
2696,P673_color_image0.jpg,122,-6,71,77,,,,
2697,P674_color_image0.jpg,122,7,80,73,,,,
2698,P676_color_image0.jpg,122,6,70,64,,,,
2699,P677_color_image0.jpg,122,-11,67,78,,,,
2700,P680_color_image0.jpg,122,-3,66,69,,,,
2701,P681_color_image0.jpg,122,-1,71,72,,,,
2702,P690_color_image0.jpg,122,10,73,63,,,,
2703,P694_color_image0.jpg,122,-11,66,77,,,,
2704,P703_color_image0.jpg,122,0,66,66,,,,
2705,P704_color_image0.jpg,122,6,78,72,,,,
2706,P710_color_image0.jpg,122,11,81,70,,,,
2707,P712_color_image0.jpg,122,-5,63,68,,,,
2708,P717_color_image0.jpg,122,1,72,71,,,,
2709,P724_color_image0.jpg,122,5,72,67,,,,
2710,P728_color_image0.jpg,122,-3,74,77,,,,
2711,P742-1_color_image0.jpg,122,11,80,69,,,,
2712,P744_color_image0.jpg,122,-4,69,73,,,,
2713,P745-1_color_image0.jpg,122,0,71,71,,,,
2714,P747_color_image0.jpg,122,11,76,65,,,,
2715,P759-1_color_image0.jpg,122,-7,71,78,,,,
2716,P766-1_color_image0.jpg,122,10,66,56,,,,
2717,P776-1_color_image0.jpg,122,12,80,68,,,,
2718,p172_color_image0.jpg,120,-1,72,73,-0.490066225,,,
2719,p175_color_image0.jpg,120,-4,73,77,,,,
2720,P188_color_image0.jpg,120,2,78,76,,,,
2721,p191_color_image0.jpg,120,-2,68,70,,,,
2722,p196_color_image0.jpg,120,-10,61,71,,,,
2723,p197_color_image0.jpg,120,-6,71,77,,,,
2724,p198_color_image0.jpg,120,-8,64,72,,,,
2725,p200_color_image0.jpg,120,-7,70,77,,,,
2726,P210_color_image0.jpg,120,-5,73,78,,,,
2727,p211_color_image0.jpg,120,-1,74,75,,,,
2728,P220_color_image0.jpg,120,5,75,70,,,,
2729,p222_color_image0.jpg,120,8,77,69,,,,
2730,p223_color_image0.jpg,120,7,72,65,,,,
2731,p230_color_image0.jpg,120,12,70,58,,,,
2732,p232-2_color_image0.jpg,120,3,78,75,,,,
2733,p237-1_color_image0.jpg,120,-8,65,73,,,,
2734,p240_color_image0.jpg,120,-14,65,79,,,,
2735,p249_color_image0.jpg,120,-1,75,76,,,,
2736,p250_color_image0.jpg,120,-2,66,68,,,,
2737,p253_color_image0.jpg,120,-4,72,76,,,,
2738,p255_color_image0.jpg,120,-1,73,74,,,,
2739,p256_color_image0.jpg,120,1,72,71,,,,
2740,p260_color_image0.jpg,120,-4,72,76,,,,
2741,p261_color_image0.jpg,120,-1,71,72,,,,
2742,p263_color_image0.jpg,120,4,72,68,,,,
2743,P267_color_image0.jpg,120,6,74,68,,,,
2744,p272_color_image0.jpg,120,-1,71,72,,,,
2745,p279_color_image0.jpg,120,9,72,63,,,,
2746,P280_color_image0.jpg,120,-1,71,72,,,,
2747,P282_color_image0.jpg,120,8,80,72,,,,
2748,p284_color_image0.jpg,120,-4,71,75,,,,
2749,p287_color_image0.jpg,120,2,73,71,,,,
2750,p288_color_image0.jpg,120,-9,69,78,,,,
2751,p289_color_image0.jpg,120,7,78,71,,,,
2752,p302_color_image0.jpg,120,8,80,72,,,,
2753,p306_color_image0.jpg,120,2,72,70,,,,
2754,p311_color_image0.jpg,120,8,86,78,,,,
2755,P321_color_image0.jpg,120,1,78,77,,,,
2756,p327_color_image0.jpg,120,-5,72,77,,,,
2757,p344_color_image0.jpg,120,-1,69,70,,,,
2758,p345_color_image0.jpg,120,5,72,67,,,,
2759,p346-1_color_image0.jpg,120,-5,63,68,,,,
2760,p347_color_image0.jpg,120,-2,71,73,,,,
2761,p351_color_image0.jpg,120,2,72,70,,,,
2762,P354_color_image0.jpg,120,-5,72,77,,,,
2763,p362_color_image0.jpg,120,-3,72,75,,,,
2764,p366_color_image0.jpg,120,-1,77,78,,,,
2765,p368_color_image0.jpg,120,-3,65,68,,,,
2766,p378_color_image0.jpg,120,-12,66,78,,,,
2767,p386_color_image0.jpg,120,-6,71,77,,,,
2768,P395_color_image0.jpg,120,-8,69,77,,,,
2769,p397_color_image0.jpg,120,-1,71,72,,,,
2770,p398_color_image0.jpg,120,-5,71,76,,,,
2771,p399_color_image0.jpg,120,1,72,71,,,,
2772,p403_color_image0.jpg,120,-3,72,75,,,,
2773,p412_color_image0.jpg,120,-4,68,72,,,,
2774,p415_color_image0.jpg,120,4,74,70,,,,
2775,p422_color_image0.jpg,120,10,66,56,,,,
2776,p424_color_image0.jpg,120,9,78,69,,,,
2777,p425_color_image0.jpg,120,-4,71,75,,,,
2778,p430_color_image0.jpg,120,-9,68,77,,,,
2779,p431_color_image0.jpg,120,-3,69,72,,,,
2780,p432_color_image0.jpg,120,-2,74,76,,,,
2781,p435_color_image0.jpg,120,1,74,73,,,,
2782,p438_color_image0.jpg,120,-6,72,78,,,,
2783,P439_color_image0.jpg,120,9,79,70,,,,
2784,p440_color_image0.jpg,120,-5,72,77,,,,
2785,p441_color_image0.jpg,120,1,71,70,,,,
2786,p442_color_image0.jpg,120,1,72,71,,,,
2787,p445_color_image0.jpg,120,-3,72,75,,,,
2788,p452_color_image0.jpg,120,-10,68,78,,,,
2789,p454_color_image0.jpg,120,-5,63,68,,,,
2790,p462_color_image0.jpg,120,-2,75,77,,,,
2791,P467_color_image0.jpg,120,1,76,75,,,,
2792,p469_color_image0.jpg,120,-8,69,77,,,,
2793,P472_color_image0.jpg,120,0,76,76,,,,
2794,p474_color_image0.jpg,120,2,72,70,,,,
2795,p477_color_image0.jpg,120,4,80,76,,,,
2796,P481_color_image0.jpg,120,-1,74,75,,,,
2797,P482_color_image0.jpg,120,-4,68,72,,,,
2798,P484_color_image0.jpg,120,0,65,65,,,,
2799,P485_color_image0.jpg,120,13,77,64,,,,
2800,P491_color_image0.jpg,120,-5,72,77,,,,
2801,P495_color_image0.jpg,120,8,77,69,,,,
2802,P499_color_image0.jpg,120,9,72,63,,,,
2803,P501_color_image0.jpg,120,-5,66,71,,,,
2804,P505_color_image0.jpg,120,10,78,68,,,,
2805,P507_color_image0.jpg,120,-4,72,76,,,,
2806,P509_color_image0.jpg,120,0,78,78,,,,
2807,P510_color_image0.jpg,120,-1,76,77,,,,
2808,P515_color_image0.jpg,120,5,78,73,,,,
2809,P518_color_image0.jpg,120,-7,71,78,,,,
2810,P519_color_image0.jpg,120,2,72,70,,,,
2811,P521_color_image0.jpg,120,10,74,64,,,,
2812,P525_color_image0.jpg,120,-4,72,76,,,,
2813,P529_color_image0.jpg,120,-2,66,68,,,,
2814,P551_color_image0.jpg,120,-3,72,75,,,,
2815,P556_color_image0.jpg,120,0,71,71,,,,
2816,P557_color_image0.jpg,120,3,74,71,,,,
2817,P564_color_image0.jpg,120,-2,65,67,,,,
2818,P565_color_image0.jpg,120,3,66,63,,,,
2819,P572_color_image0.jpg,120,-5,73,78,,,,
2820,P575_color_image0.jpg,120,11,69,58,,,,
2821,P576_color_image0.jpg,120,4,71,67,,,,
2822,P577_color_image0.jpg,120,-5,72,77,,,,
2823,P578_color_image0.jpg,120,5,74,69,,,,
2824,P582_color_image0.jpg,120,9,78,69,,,,
2825,P585_color_image0.jpg,120,1,72,71,,,,
2826,P586_color_image0.jpg,120,-6,72,78,,,,
2827,P592_color_image0.jpg,120,-5,64,69,,,,
2828,P594_color_image0.jpg,120,-12,66,78,,,,
2829,P596_color_image0.jpg,120,2,74,72,,,,
2830,P601_color_image0.jpg,120,0,72,72,,,,
2831,P602_color_image0.jpg,120,0,69,69,,,,
2832,P605_color_image0.jpg,120,1,72,71,,,,
2833,P606_color_image0.jpg,120,-5,72,77,,,,
2834,P609_color_image0.jpg,120,1,72,71,,,,
2835,P612_color_image0.jpg,120,1,76,75,,,,
2836,P617_color_image0.jpg,120,3,77,74,,,,
2837,P618-1_color_image0.jpg,120,-3,71,74,,,,
2838,P619_color_image0.jpg,120,-8,69,77,,,,
2839,P622_color_image0.jpg,120,0,75,75,,,,
2840,P632_color_image0.jpg,120,-7,72,79,,,,
2841,P635_color_image0.jpg,120,-12,65,77,,,,
2842,P636_color_image0.jpg,120,6,79,73,,,,
2843,P638_color_image0.jpg,120,4,77,73,,,,
2844,P645_color_image0.jpg,120,-5,71,76,,,,
2845,P651_color_image0.jpg,120,-3,69,72,,,,
2846,P653_color_image0.jpg,120,2,79,77,,,,
2847,P673_color_image0.jpg,120,-5,72,77,,,,
2848,P674_color_image0.jpg,120,0,73,73,,,,
2849,P676_color_image0.jpg,120,2,66,64,,,,
2850,P677_color_image0.jpg,120,-7,71,78,,,,
2851,P680_color_image0.jpg,120,1,70,69,,,,
2852,P681_color_image0.jpg,120,1,73,72,,,,
2853,P690_color_image0.jpg,120,9,72,63,,,,
2854,P694_color_image0.jpg,120,-11,66,77,,,,
2855,P703_color_image0.jpg,120,0,66,66,,,,
2856,P704_color_image0.jpg,120,-7,65,72,,,,
2857,P710_color_image0.jpg,120,-1,69,70,,,,
2858,P712_color_image0.jpg,120,4,72,68,,,,
2859,P717_color_image0.jpg,120,3,74,71,,,,
2860,P724_color_image0.jpg,120,2,69,67,,,,
2861,P728_color_image0.jpg,120,0,77,77,,,,
2862,P742-1_color_image0.jpg,120,1,70,69,,,,
2863,P744_color_image0.jpg,120,3,76,73,,,,
2864,P745-1_color_image0.jpg,120,-6,65,71,,,,
2865,P747_color_image0.jpg,120,7,72,65,,,,
2866,P759-1_color_image0.jpg,120,-13,65,78,,,,
2867,P766-1_color_image0.jpg,120,12,68,56,,,,
2868,P776-1_color_image0.jpg,120,4,72,68,,,,
2869,p172_color_image0.jpg,123,-2,71,73,-0.19205298,,,
2870,p175_color_image0.jpg,123,-2,75,77,,,,
2871,P188_color_image0.jpg,123,2,78,76,,,,
2872,p191_color_image0.jpg,123,2,72,70,,,,
2873,p196_color_image0.jpg,123,-7,64,71,,,,
2874,p197_color_image0.jpg,123,3,80,77,,,,
2875,p198_color_image0.jpg,123,-3,69,72,,,,
2876,p200_color_image0.jpg,123,1,78,77,,,,
2877,P210_color_image0.jpg,123,-1,77,78,,,,
2878,p211_color_image0.jpg,123,3,78,75,,,,
2879,P220_color_image0.jpg,123,8,78,70,,,,
2880,p222_color_image0.jpg,123,6,75,69,,,,
2881,p223_color_image0.jpg,123,12,77,65,,,,
2882,p230_color_image0.jpg,123,17,75,58,,,,
2883,p232-2_color_image0.jpg,123,2,77,75,,,,
2884,p237-1_color_image0.jpg,123,1,74,73,,,,
2885,p240_color_image0.jpg,123,-8,71,79,,,,
2886,p249_color_image0.jpg,123,-3,73,76,,,,
2887,p250_color_image0.jpg,123,2,70,68,,,,
2888,p253_color_image0.jpg,123,-6,70,76,,,,
2889,p255_color_image0.jpg,123,0,74,74,,,,
2890,p256_color_image0.jpg,123,1,72,71,,,,
2891,p260_color_image0.jpg,123,-13,63,76,,,,
2892,p261_color_image0.jpg,123,0,72,72,,,,
2893,p263_color_image0.jpg,123,3,71,68,,,,
2894,P267_color_image0.jpg,123,4,72,68,,,,
2895,p272_color_image0.jpg,123,1,73,72,,,,
2896,p279_color_image0.jpg,123,9,72,63,,,,
2897,P280_color_image0.jpg,123,-2,70,72,,,,
2898,P282_color_image0.jpg,123,6,78,72,,,,
2899,p284_color_image0.jpg,123,-3,72,75,,,,
2900,p287_color_image0.jpg,123,1,72,71,,,,
2901,p288_color_image0.jpg,123,-9,69,78,,,,
2902,p289_color_image0.jpg,123,10,81,71,,,,
2903,p302_color_image0.jpg,123,0,72,72,,,,
2904,p306_color_image0.jpg,123,4,74,70,,,,
2905,p311_color_image0.jpg,123,2,80,78,,,,
2906,P321_color_image0.jpg,123,-3,74,77,,,,
2907,p327_color_image0.jpg,123,-6,71,77,,,,
2908,p344_color_image0.jpg,123,2,72,70,,,,
2909,p345_color_image0.jpg,123,2,69,67,,,,
2910,p346-1_color_image0.jpg,123,-7,61,68,,,,
2911,p347_color_image0.jpg,123,-2,71,73,,,,
2912,p351_color_image0.jpg,123,1,71,70,,,,
2913,P354_color_image0.jpg,123,-5,72,77,,,,
2914,p362_color_image0.jpg,123,-2,73,75,,,,
2915,p366_color_image0.jpg,123,-6,72,78,,,,
2916,p368_color_image0.jpg,123,4,72,68,,,,
2917,p378_color_image0.jpg,123,0,78,78,,,,
2918,p386_color_image0.jpg,123,-7,70,77,,,,
2919,P395_color_image0.jpg,123,-6,71,77,,,,
2920,p397_color_image0.jpg,123,2,74,72,,,,
2921,p398_color_image0.jpg,123,-11,65,76,,,,
2922,p399_color_image0.jpg,123,0,71,71,,,,
2923,p403_color_image0.jpg,123,-3,72,75,,,,
2924,p412_color_image0.jpg,123,5,77,72,,,,
2925,p415_color_image0.jpg,123,0,70,70,,,,
2926,p422_color_image0.jpg,123,15,71,56,,,,
2927,p424_color_image0.jpg,123,9,78,69,,,,
2928,p425_color_image0.jpg,123,-3,72,75,,,,
2929,p430_color_image0.jpg,123,-3,74,77,,,,
2930,p431_color_image0.jpg,123,-6,66,72,,,,
2931,p432_color_image0.jpg,123,-3,73,76,,,,
2932,p435_color_image0.jpg,123,-1,72,73,,,,
2933,p438_color_image0.jpg,123,-13,65,78,,,,
2934,P439_color_image0.jpg,123,4,74,70,,,,
2935,p440_color_image0.jpg,123,-5,72,77,,,,
2936,p441_color_image0.jpg,123,2,72,70,,,,
2937,p442_color_image0.jpg,123,-1,70,71,,,,
2938,p445_color_image0.jpg,123,-4,71,75,,,,
2939,p452_color_image0.jpg,123,-6,72,78,,,,
2940,p454_color_image0.jpg,123,0,68,68,,,,
2941,p462_color_image0.jpg,123,0,77,77,,,,
2942,P467_color_image0.jpg,123,2,77,75,,,,
2943,p469_color_image0.jpg,123,-11,66,77,,,,
2944,P472_color_image0.jpg,123,-1,75,76,,,,
2945,p474_color_image0.jpg,123,-1,69,70,,,,
2946,p477_color_image0.jpg,123,-4,72,76,,,,
2947,P481_color_image0.jpg,123,-1,74,75,,,,
2948,P482_color_image0.jpg,123,-8,64,72,,,,
2949,P484_color_image0.jpg,123,4,69,65,,,,
2950,P485_color_image0.jpg,123,15,79,64,,,,
2951,P491_color_image0.jpg,123,-11,66,77,,,,
2952,P495_color_image0.jpg,123,11,80,69,,,,
2953,P499_color_image0.jpg,123,6,69,63,,,,
2954,P501_color_image0.jpg,123,-8,63,71,,,,
2955,P505_color_image0.jpg,123,10,78,68,,,,
2956,P507_color_image0.jpg,123,-5,71,76,,,,
2957,P509_color_image0.jpg,123,0,78,78,,,,
2958,P510_color_image0.jpg,123,0,77,77,,,,
2959,P515_color_image0.jpg,123,3,76,73,,,,
2960,P518_color_image0.jpg,123,-7,71,78,,,,
2961,P519_color_image0.jpg,123,-5,65,70,,,,
2962,P521_color_image0.jpg,123,8,72,64,,,,
2963,P525_color_image0.jpg,123,1,77,76,,,,
2964,P529_color_image0.jpg,123,1,69,68,,,,
2965,P551_color_image0.jpg,123,-3,72,75,,,,
2966,P556_color_image0.jpg,123,7,78,71,,,,
2967,P557_color_image0.jpg,123,7,78,71,,,,
2968,P564_color_image0.jpg,123,1,68,67,,,,
2969,P565_color_image0.jpg,123,9,72,63,,,,
2970,P572_color_image0.jpg,123,-1,77,78,,,,
2971,P575_color_image0.jpg,123,10,68,58,,,,
2972,P576_color_image0.jpg,123,4,71,67,,,,
2973,P577_color_image0.jpg,123,-5,72,77,,,,
2974,P578_color_image0.jpg,123,0,69,69,,,,
2975,P582_color_image0.jpg,123,3,72,69,,,,
2976,P585_color_image0.jpg,123,-1,70,71,,,,
2977,P586_color_image0.jpg,123,-7,71,78,,,,
2978,P592_color_image0.jpg,123,-4,65,69,,,,
2979,P594_color_image0.jpg,123,-6,72,78,,,,
2980,P596_color_image0.jpg,123,5,77,72,,,,
2981,P601_color_image0.jpg,123,-9,63,72,,,,
2982,P602_color_image0.jpg,123,1,70,69,,,,
2983,P605_color_image0.jpg,123,-3,68,71,,,,
2984,P606_color_image0.jpg,123,1,78,77,,,,
2985,P609_color_image0.jpg,123,3,74,71,,,,
2986,P612_color_image0.jpg,123,-3,72,75,,,,
2987,P617_color_image0.jpg,123,2,76,74,,,,
2988,P618-1_color_image0.jpg,123,6,80,74,,,,
2989,P619_color_image0.jpg,123,1,78,77,,,,
2990,P622_color_image0.jpg,123,-3,72,75,,,,
2991,P632_color_image0.jpg,123,-7,72,79,,,,
2992,P635_color_image0.jpg,123,-7,70,77,,,,
2993,P636_color_image0.jpg,123,-3,70,73,,,,
2994,P638_color_image0.jpg,123,1,74,73,,,,
2995,P645_color_image0.jpg,123,-10,66,76,,,,
2996,P651_color_image0.jpg,123,-3,69,72,,,,
2997,P653_color_image0.jpg,123,3,80,77,,,,
2998,P673_color_image0.jpg,123,-8,69,77,,,,
2999,P674_color_image0.jpg,123,-3,70,73,,,,
3000,P676_color_image0.jpg,123,13,77,64,,,,
3001,P677_color_image0.jpg,123,-9,69,78,,,,
3002,P680_color_image0.jpg,123,0,69,69,,,,
3003,P681_color_image0.jpg,123,3,75,72,,,,
3004,P690_color_image0.jpg,123,8,71,63,,,,
3005,P694_color_image0.jpg,123,-11,66,77,,,,
3006,P703_color_image0.jpg,123,-3,63,66,,,,
3007,P704_color_image0.jpg,123,3,75,72,,,,
3008,P710_color_image0.jpg,123,-7,63,70,,,,
3009,P712_color_image0.jpg,123,-5,63,68,,,,
3010,P717_color_image0.jpg,123,1,72,71,,,,
3011,P724_color_image0.jpg,123,5,72,67,,,,
3012,P728_color_image0.jpg,123,-5,72,77,,,,
3013,P742-1_color_image0.jpg,123,3,72,69,,,,
3014,P744_color_image0.jpg,123,0,73,73,,,,
3015,P745-1_color_image0.jpg,123,-6,65,71,,,,
3016,P747_color_image0.jpg,123,12,77,65,,,,
3017,P759-1_color_image0.jpg,123,-8,70,78,,,,
3018,P766-1_color_image0.jpg,123,12,68,56,,,,
3019,P776-1_color_image0.jpg,123,4,72,68,,,,
